jujur nyaman pakai ajaib eh error verifikasi identitas akun bulanan usianya isi aset btc eth kecewa sih ajaib error	negative
install aplikasi portofolio saham hilang aplikasi ajaib satunya min tolong penjelasannya	neutral
aplikasi bagus bermanfaat	positive
tolong tambahkan fitur tersadar profit	positive
tidak stop lost kalau mempertahanakan trader wajib stop lost kalau metrade trailing stop b kalau strailing stop	positive
berita bahas inggris	neutral
aplikasi bagus sayangnya tidak mengirim kripto dompet terima kripto terbatas aset	positive
aplikasinya praktis mudah cocok pemula belajar fiturnya rekomended	positive
ajaib mengapa tidak login login eror perbaiki	positive
penghasilan bulanan	neutral
kolom dibutuhkan kosong digital signature tolong perbaiki	positive
bagus sih aplikasi sayang pajak bungnya perpindahan mata uang rupiah usdt token usdt harap usdt ganjil genap tranfers token usdt minimunya usdt platfrom transfer token usdt harap transfer token crypto kasih bintang perbaiki ubah	positive
deposit masuk masuk dana nya	neutral
mencoba aplikasi crypto terbaik pembaruan harga real time akurat berita memberikan wawasan berharga pasar merekomendasikan siapa mencari aplikasi crypto andal	positive
saran ajaib kripto tidak rekomendasi orang belajar kripto hambatan temui harga pasar tidak sesuai penarikan susah semacamnya	negative
keren investasi pemula mudah dimengerti	positive
pembayaran rnd baca tensorflow rupiah masuk saldo rnd tolong perbaiki uang bantuan terima kasih	positive
belajar	neutral
aplikasinya bagus cocok pemula pakainya gampang bahas mudah mengerti	positive
semoga koin koinya kalau mengurangi biaya feenya ya	positive
aplikasi bagus mudah dimengerti uang rebahan membantu belajar masukan refferal as ch biar akunmu terverifikasi semoga beruntung	positive
bagus masukan kalau fitur cek profit kayak ajaib saham	positive
mengajukan perubahan akun rekening tolak alasan tidak akun bank	negative
saldo hilang juta riwayat tidak pembelian kripto senilai juta parah	negative
sangatt membantu pemulla fitur nya gampang bagus	positive
aplikasi jelek koin tidak	negative
aplikasi keren belajar investasi mudah verifikasinya cepat lho anti rumit rumit club	positive
aplikasi the best transaksi gampang mudah memahami	positive
menikmati fitur ajaib crypto kecewa tanpa alasan pesanan beli rejeck tidak pesanan beli coin harap tindak ajaib tidak kecewa aplikasi ajaib jelek aplikasi tidak menyediakan live chat melayani keluhan pengguna menannyakan aplikasi langsung	negative
aplikasi cacat kalau sell harga lag pas harga turun jual mending apk sebelah	negative
update tambahkan widget nya min tidak widgetnya	neutral
mending suka error parah rugi juta	negative
cocok pemula fiturnya simple mudah dipahami	positive
login bermasalah jaringan bagus	positive
bug gangguan	neutral
fee nya mahal bjirr	neutral
tampilan menarik fitur memadai memudahkan pemula direkomendasikan pemula coba coba belajar kripto	positive
tolong tingkatkan stabil	positive
akun tidak login pesan kalau email tidak terdaftar	neutral
apknya bagus mudah belajar pakai kripto membantu	positive
error aplikasi error akun error kendala respon penanganan lambat stop memakai aplikasi token aset miliki hilang aplikasi mengerikan	negative
bagus pertahankan	positive
aplikasi investasi terbaik fitur fitur nya user friendly mudah dipahami suka pokoknya	positive
iseng aplikasi treding ketemu ajaib kripto mudah tampilan friendly mantap	positive
tidak buka jam	negative
aplikasi ajaib kripto memberikan solusi lengkap kebutuhan investasi kripto pembelian manajemen portofolio	positive
jual belinya tidak cepat tidak enak	negative
proses pembukaan akun proses selesai	neutral
simpel pemula trader	neutral
aplikasi eror data tidak busa diliha	negative
biaya penarikannya mahal kali mahal biaya transfer bank biaya topup saldo allah allah	positive
aplikasi penarikan dana malam gangguan uninstall	negative
aplikasinya bagus cepat layanannya oke prosesnya cepat mantap deh	positive
apknya bagus penjelasan fiturnya mudah dimengerti enak dipandang cocok pemula dunia perkriptoan	positive
aplikasi mudah user friendly transaction mudah rekomen deh	positive
kenapa aplikasi ajaib kripto eror pas aplikasi kripto foto ktp foto mengapa tidak masuk sepuluh kali foto tolong aplikasi ajaib kripto pengguna masak erro aplikasi takut invetasi uang eror aplikasi nya	negative
kecewa ajaib cripto uangku hilang setenga modal gara biaya transaksi jaringan mahal	negative
beli jualnya simpel	neutral
pemakaian bagus tolong tambahkan layanan penggunaan sidik jari membuka aplikasi ajaib kripto orang ajaib kripto tidak tolong tambahkan layanan nya manual	positive
parah aset hilang tidak jual wd akun terdaftar mendadak tidak terdaftar aset rupiah silakan download mengalami	negative
aplikasi tidak deposit	negative
bug	neutral
sinyal jelek chart nya dihilangkan	negative
aplikasi bagus kalangan orang belajar seputar dunia kripto tampilan menarik fitur mudah dimengerti memudahkan pengguna aplikasi	positive
aplikasi nya kenapa min bug kah	neutral
disarankan aplikasi pemula belajar investasi kayak fitur aplikasi mudah difahami	positive
kenapa lambat tidak lihat aset	negative
aplikasi penipu update bertingkah semalam set auto jual dinonaktifkan bullish loh turun normal ajaib penipuan mah	negative
maintenance	neutral
koin ondo kenapa hilang tidak aman aplikasi	negative
aplikasi ajaib kripto bikin jual beli kripto ui nya cakap fiturnya simple belajar kripto tidak rumit	positive
tidak masuk ganti nama n password n rekening bank	neutral
mudah aman menyenangkan	positive
bagus fitur sl mengurangi kerugian minggu senin mesti mantenance tidak jual nya untung boncos tidak jual tolong dikurangi mantenance nya	negative
aplikasi investasi membantu semoga depannya keren fiturnya	positive
aplikasi error daftar pas suruh foto ktp tidak tidak jelass	negative
lengkap cepat bertransaksi ceypto	neutral
bagus kalau biaya admin penarikan pluang min coin aset cyripto biar	positive
kenapa uang nya tidak ditarik invest baca	neutral
kenapa ya ajaib crypto tidak muncul grafik harga nya tolong min oerbaiki	positive
whitdraw minggu masuk rekening disayangkan	negative
pokoknya the best menemani investasi modal rekomendasi ajaib	positive
jam ajaib tidak loding tidak terbaca aset mengecek market merugika infestor	negative
suka aplikasi kripto ajaib berkat aplikasi bingung kripto paham	positive
jelek aturan beli kirim kripto minimal pembelian pengiriman berbedaÂ² pokoknya jelek wd mahal aplikasi terbilang	negative
gap jual beli kalau jual market order loss nya iming pajak lossnya gara-gara gap jual harga pasarnya beda	negative
rekomen pemula fitur fiturnya mudah mengerti belajar kripto langsung paham dia cairin dana e wallet gampang tidak ribett	positive
kasih akun terverifikasi	neutral
mencoba	neutral
cocok pemula belajar investasi fitur aplikasi mudah dipahami pengaktifan aplikasi verifikasi mudah	positive
bagus aplikasi nya mudah membantu bidang kripto pemula mudah gampang akses nya	positive
apalah daya pemula untung nya bayar transaksi	positive
salah apk trading simpel interface fitur bagus pemula	negative
aplikasi tidak tanggung koin ondo	neutral
aplikasinya mudah dipahami tidak bikin pusing pengguna fitur fitur nya kinian	positive
aplikasi mudah difahami tampilan nya menarik cocok pemula direkomendasikan kawan-kawan	positive
aplikasinya mudah panduannya memudahkan pengguna	positive
bintang sih fiturnya lengkap aplikasinya mudah dipahami tampilannya simpel nyaman mata cocok pemula belajar kripto	positive
pengiriman usdt tolong perubahan no telepon akun diganti	positive
penambahan informasi usdt rupiah bermasalah reload resource info berulang flow logicnya tidak simple kirim log error tidak debugging apa	negative
aplikasi mudah memahami cocok pemula	positive
ajaib kripto bagus fiturnya mudah dipahami cocok pemula belajar	positive
tampilan mudah memahami	positive
takut kalau kripto pakai apk tidak takut mudah bikin ketagihan semoga uang	positive
apk terbaik cocok pemula panduannya tidak rumit mudah cocok deh pemula kayak the best deh	positive
cocok pemula fitur fiturnya mudah dimengerti tidak bikin pusing tampilannya bagus	positive
bug nya pas beli market order delay	negative
mantap aplikasi jual beli crypto mudah aman diawasi bappebti cocok pemula	positive
aplikasi memudahkan sih fiturnya modern sederhana transaksi tidak kendala loh	negative
apdet lajut lajut	neutral
aplikasi busuk tranding	negative
buka akun mengapa repotnya ampun apk aneh transaksi susah merepotkan admin minim respon no rekomendasi kawan	negative
tidak jual pakai limit order market	neutral
seminggu memakai aplikasi ajaib kripto trading mudah praktis aplikasi nya lancar tidak lag	negative
aplikasinya menarik pemula mudah dipahami tingkatkan fiturnya keren	positive
ondo listing apknya langsung eror coin ajaib aneh	negative
terkena bug beli ondo harga cek ulang ondo rugi bug	negative
tidak bagus	negative
kenapa aplikasinya tidak buka	neutral
pesan download deposit aplikasi fiturnya minim buy sel tidak tersedia menu penarikan dompet krypto	negative
ggrafiknya tidak kayak bug	negative
harganya beda escange	neutral
loginnya mudah kalau terconnect aplikasi ajaib friendly user menunya mudah memahami pilih bahasa indonesia	positive
depot jual beli kripto	neutral
perbaiki sistemnya update crypto koin listing tidak muncul koin barunya	neutral
tidak market historynya tidak orang jual tidak apa market harganya	negative
salah aplikasi investasi kripto amanah	neutral
aplikasi bagus pemula update coin tersedia	positive
deposit nya cepat giliran withdraw nya balesannya kayak tidak bertanggung aduh parah sih kalau tidak dibalikin uang ku kalau dibalikin ku menaikkan bintang nya uang ku pulang	negative
miningnya pas ngeclaim stak ngebuka peti apk scam aneh banget	negative
aplikasi aman cocok kita berinvestasi percaya aman kita gampang kita pemula	positive
apk bagus pemula pakainya gampang tidak bikin bingung apk kripto terbaik pemula sih best	positive
kenapa penarikan tidak masuk	neutral
undang teman capai capai suruh deposit transaksi eh menunggu seminggu bonus tidak diproses proses aplikasi sampah chat layanan pelanggan nya apa apa hapus aplikasi sampah	positive
mengapa tidak ferivikasi ya kenapa min	neutral
aplikasi ajaib memudahkan belajar kripto fitur fitur nya menarik mudah dipahami	positive
fitur membingungkan biaya transaksi mahal fee withdraw pemula	negative
kenapa upgrade aplikasi nya grafik nya berubah mind bukan grafik candle	neutral
aplikasi berguna investasi tidak rumit tinggal mengikuti prosedur lancar	positive
aplikasin bagus pemula modalny tidak gede tampilan modern style fiturnya cuku oke	positive
ui simple mudah pemula kekurangan exchange ajaib crypto listing coin	positive
dipakai ya putrkpgj pemula cocok aplikasi investasi cepat kita paham tidak rumit menggunakannya terpercaya terdaftar ojk investasi jangka pendek jangka scalping aplikasi mantap teman-teman	positive
pilihan coin helium quant layer kripto	neutral
aplikasi anak muda finansial freedom muda cocok nih belajar invest aplikasi mudah thank you	positive
kenapa susahh wd pin kenapa salah cobalagi	neutral
kenapa pas maining monyetnya memukuli beliungnya laya hitam gambar hitam gambar pas sih monyetnyq memukuli beliungnya	positive
apknya jelek	negative
bagus aplikasi ya membantu anak muda investasi mudah cepat aman	positive
berminggu tidak nambang jelek aplikasiny	negative
mencoba proses verifikasi data nya tidak menyetujui ber jam jam lolos verifikasi saran pekerjakan karyawan jam bikin shif melayani data pembukan akun investasi bukan pinjol apl tidak menit proses kyc	negative
aplikasi bagus investasi mudah pastinya aman the best deh apk tidak ragu deh	positive
layanan pelanggan nya tidak balas	neutral
bagus atraktif jaga keamanan investor kembangkan	positive
aplikasi payah tidak jls	neutral
besok kalau auto order	neutral
sarankan pakai ajaib mending pakai indodax hasil penjualan diproses bikin rugi ajaib fee nya gede	positive
aplikasi mudah aman gampang ditransaksi	positive
rekomend belajar crypto teman-teman	positive
tingkat performa nya	neutral
apk nya bagus mudah pelajari	positive
pembayaran adminnya meras dana adminnya ngotaklah	negative
aplikasi membantu pemula belajar kripto fitur fitur nya mudah tampilan nya moderen stylish nyaman akses aman percaya	positive
minimal penarikan nya tidak kayak ribu tolong turun ribu	negative
aplikasi penipu terbaik deposit minimal ribu kalau penarikan minimal ribu kalau tipu terang terangan iklan manis aslinya aplikasi sampah	positive
download apk suka eror gara eror mines menit hati	negative
fitur aplikasinya mudah dipahami pemula pencairannya e wallet transfer bank prosesnya cepat direkomendasikan pokoknya	positive
aplikasi mudah terpercaya aman	positive
aplikasi jelek download	negative
mantap aplikasi kirim terima tinggal menunggu fitur staking earn semoga aplikasi cepat upgrade biar tidak kalah saing	positive
minimal deposit nya diturunin tidak kayak pluang rupiah	negative
habis update nge lag	negative
main kripto tidak masuk akal masuk rekening	positive
pusing efek angka koma kembalikan	negative
verifikasinya kemarin tanggal siang tanggal	neutral
sih appnya penarikan gagal uangnya butuh	negative
aplikasi tolol tidak verifikasi identitas tidak buka akun investasi koneksi terganggu eror	negative
aplikasi ajaib bagus kadang log selebihnya bagus	positive
pemula berani nilai mengunakan	positive
pas pemula belajar invest kripto aplikasinya tidak susah tampilannya oke	positive
amankan uangmu investasi ajaib kripto aman terpercaya tidak pakai rumit	positive
kalau runing ngepump mesti tidak dibuka balancenya aduh	neutral
jual crypto tidak tidak exchange all contoh sol jual beli nya input input maksimal bingung saldo nya	negative
chart nya kadang suka ngelag semoga update ditingkatkan over all aplikasi nya user friendly	positive
lelet buy harga rendah turun sell ah cemen aplikasi lambat	negative
aplikasinya bagus gampang dioperasikan aman tenang naruh aset terbukti aman rekomended	positive
aplikasi investasi tidak rumit gampang pas investasinya	negative
mengambil uang depot dana ya	neutral
aplikasi tolol tidak menarik saldo nya	neutral
stop buy sell opsioanal contoh stop buy rupiah harga rupiah koin tidak terbeli stop sell	negative
tolong server nya perbaiki jual berputar	positive
suka apk mudah akses	positive
hati hati nanam cripto gap harga pasa harga aplikasi jau kecurangan	negative
anjing hilang gara gara suruh akun tidak akun	negative
penggunaannya mudah dimengerti kendala pengoperasiannya mudah pemula	positive
belajar investasi kripto membantu panduannya dimengerti	positive
aplikasi tolol penipuan ngejual saldo hilang entah kemana	negative
sampah	neutral
deposit rek permata ajaib kripto eh disuruh deposit akun kripto bayar apa sih kalau tidak sistem depositnya rugi	negative
aplikasi mem bagong bikin orang miskin	negative
aplikasi berguna fiturnya lengkap no bug berguna pengasilan cair nya mudah cepat	positive
aplikasinya tidak ngebug layanannya respon cocok nih pemula investasi download aplikasi nikmati fitur fiturnya gampang dimengerti	positive
profit tidak jual	positive
mining nya tidak luama hasil	neutral
seminggu verifikasi nya selesai	neutral
aplikasinya lengkap gampang dipakainya pemula overall suka thebest deh recommend pokoknya	positive
membatu perekonomian	negative
daftar susah seminggu eror pas verifikasi identitas susah nik terdaftar email rasana pernh hduh bikin pusing	negative
lambat	neutral
proses verifikasi dipersulit tidak aplikasi sebelah beroperasi indonesia	negative
parah ajaib kripto deposit tidak masuk pindah aplikasi sebelah ya payah nih ajaib kripto mah ondo loncat deposit tidak masuk payah	negative
aplikasinya simple mudah dimengerti banget pemula belajar kripto fitur fiturnya sederhana tidak rumit	positive
bagus pemula	positive
modal juta mending pakai modal gede bikin rungkat apk pas beli transaksi tidak manchet saldo potong membatalkan tidak menunggu nit eh matchet beli harga bawahh modal juta rugi kadang suka eror chat admin respon	negative
terinstall log out akunnya invest download aplikasi	neutral
aplikasi crypto terbaik interface mudah dipahami awam keren	positive
aplikasi bagus beli crypto jual tidak sisa crypto apakan	positive
verifikasi akun	neutral
apk mahal wd keba biyaya apk sebelah gratis tidak rekomed	positive
sistem bagus suka kalau ditambahin fitur stacking min	positive
bagus aplikasi nya cocok pemula investasi	positive
susah buka aplikasi ya	negative
mantap pemula mudah memahami	positive
uang menunggu puluhan rambut berwarna putih terima kirim tidak aplikasi tranding tidak berguna sungguh kecewa kasihan belajar korban menunggu bisanya memantau tolong permudah biar orang tidak kecewa	negative
eror aplikasi nya ambil hadiah eror	negative
mantap aplikasinya jual beli aset aman suka diperbaikii halamannya biat transaksinya gampang	positive
e walletnya tolong ditambah kalau lengkap leluasa depot wd	positive
aplikasi trading mudah fitur aplikasi lengkap aplikasi berizin aman	positive
najis aplikasi lambat apa pitur earen nya tipu ganti rekening aplikasi bloon	negative
event undang temannya tidak	negative
aplikasinya mudah dimengerti pemula kendala fitur suka pokoknya disarankan pemula	positive
accnya kemarin menyetujui jam	positive
uang pastinya	positive
ajaib nama aplikasinya fitur fitur mudah memudahkan investasi	positive
aplikasi nya mudah pemula tampilan mudah mengerti fiturnya lengkap	positive
kalau usul aset kripto aplikasi saham ajaib dihapus	positive
tidak paham	neutral
tarik saldo fiturnya ora	neutral
fitur nya lengkap terpercaya aman	positive
aplikasinya mudah pemula pas depot gampang rekomen pokoknya	positive
aplikasi apa ya pakai jelek	negative
kenapa tidak jual crypto ya min penjualan	neutral
aplikasinya mudah gampang pemula membantu inventasi	positive
tolong windraw nya kasih ewalet kalau kasih ewalet auto buntang	positive
aplikasinya jelek tidak main mending pindah sekuritas kemarin coin ondo nge dump parah harga kasihan buy harga match harga apk ajaib ya maaf fitur sell dibuka fitur buy nya ditutup aneh sumpah profit kali mereka	negative
maintenance tidak transaksi mati mending ganti aplikasi	positive
aplikasinya bagus pemula belajar kripto tidak rumit mudah	positive
eror	negative
aplikasi fitur mudah pemula mudah diakses mantap	positive
sih ku gampang ya pakai aplikasi tidak rumit tinggal sat set sat set lancar kalau sesuai prosedur ya	positive
ajaib kripto bikin investasi kripto nyaman mudah pemula awam coba coba tanpa takut salah fiturnya gampang dimengerti	positive
aplikasinya bagus nih pemula mudah dipahami fitir jual beli transakasi kripto penarikan dana cepat	positive
tidak daftar	neutral
bagus pemula tampilan aplikasinya enak lihat mudah dipahami legal cocok coba belajar trading kripto	positive
aplikasi bagus belajar investasi trading mudah penggunaannya	positive
tidak beres tidak beli koin ondo	neutral
maaf aplikasinya bermasalah pas beli kripto pembelian tidak diakses saldonya beli	negative
aplikasi nya bagus terpercaya nyaman ajaib memudahkan belajar kripto fitur fiturnya mudah dipahami	positive
tolong token bone shibaswap ketinggalan sebelah terima kasih	positive
pelayanan layanan pelanggan nya lambat laporan gagal ganti rekening tanggapi	negative
aplikasi nya membantu pemula investasi aman terpercaya aman	positive
fee nya murah sayang coinnya	positive
maintanance	neutral
aplikasi cocok pemula belajar berinvestasi tampilan aplikasinya mudah dipahami fitur nya mendukung bahasa indonesia	positive
proses kyc nya sumpah	neutral
pengguna memasukan kode biar koin gratis siapa juta koinnya astacbgf ya kodenya salam uang	positive
customer servicenya update tidak info notifikasi Instagram sih chat balas minimal kasih penjelasan Instagram story twitter akun kalau	neutral
layanan pelanggan nya slow respon penanganan nya buruk nunngu jam tidak clear reward event telat bintang	negative
download ajaib scam sulit menjual aset	negative
habis coba aplikasi kripto ajaib kripto bikin ketagihan	neutral
sistem aplikasi buruk aplikasi kasih sebelah ketimbang download kecewa menyesal merasakan	negative
aplikasi crypto keren fix no debat pemula belajar crypto tampilan apknya stylish keren list kriptonya lengkap bitcoin mantap no debat pokoknya ajaib crypto	positive
aplikasi snagat bagus dimengerti fitur nya tidak bikin pusing bagus pemula cari aplikasi kripto rekoemndasi pokoknya uang teman-teman tautkan revfrral p and akunmu terverifikasi ya	positive
mantap gan aplikasinya mudah dimengerti	positive
trouble deposit	negative
akurat nih aplikasi	neutral
aplikasi membantu jenis investasi nya pemula bermanfaat	positive
aplikasi kripto ajaib disarankan ajaib sih bingung awam kripto mah tidak bingung	positive
lengkap berita news	neutral
aplikasi bagus menguntungkan pemula terjun kripto an	positive
download aplikasi crypto mudah cepat memahami terima kasih ajaib kripto hadir memberikan kemudahan pengguna nya	positive
membantu uang	positive
kawan-kawan habis coba aplikasi kripto ajaib langsung kripto bikin ketagihan tidak menyesal gunain aplikasi kripto ajaib cocok pemula tidak rumit	positive
widraw minggu jam kerja senin cair kenapa manual kalau audah sistem digitalisasi programere pekok	positive
aplikasi tidak	neutral
pembelian susah	negative
download apk merugikan	neutral
aplikasi bagus trader pemula pengalaman memaksimalkan fitur pencatatan bulanan mempermudah pengecekan nilai portofolio	positive
penasaran investasi kripto temu ajaib kripto bikin belajarnya enjoyable semoga oke fitur fiturnya biar stay disarankan pemula	positive
kenapa ondo kagabisa beli woe	positive
aplikasi investasi mudah pemula fitur fiturnya mudah dipahami pokoknya disarankan deh	positive
bagus menghabiskan duit	positive
proses setoran lain-lain earn payah pengelolanya kayak menghambat traiding	neutral
dikenakan biaya pajak biaya transaksinya kena kali jual beli kena biaya transaki pajak potongan nya untungnya	positive
menyenangkan tunggu login webside perbanyak listing coin	positive
biaya transaksi biaya pajaknya gila	negative
aplikasi penipuan buktikannya korbannya mohon berwajib blokir aplikasi ajaib crypto	negative
pemula pakai aplikasi ajaib kripto mudah dimengerti tampilannya simple fiturnya oke	positive
ngelag rugi	negative
aplikasi bosok giliran untung eror tidak take profit normalnya menunggu minus kayak rampok berkedok broker	positive
belajar crypto pemula wajib download sih fiturnya keren arahan	positive
tidak verifikasi ktp cemanya	neutral
tolong harga delay masak samain broker harganya beda	neutral
reff putrkpgj pengguna bonus serius aplikasinya bagus pemula investasi crypto lamabisa dyor kalau investasi duit kita pakai uang dingin ya teman-teman uang kebutuhan sehari kalau sultan mendadak mantb	positive
aplikasi bagus kadang lambat sih	positive
aplikasi membantu pemula modal pas pasan fitur memadai pengguna	positive
ragu ragu mendownload aplikasi mendownload aplikasi tidak menyesal suka fitur fiturnya menemukan aplikasi kripto akurat terpercaya fitur lengkap pelayanan fast respon sopan csnya cari aplikasi investasi kripto beli kripto jual kripto coba aplikasi dijamin tidak menyesal	positive
eror	negative
aplikasi nya lambat	neutral
mohon penarikan nya wallet dana shopee ovo biar pakai aplikasi kalau bintang	positive
kenal	neutral
tidak bingung kripto apk mudah pemula	negative
versi webnya biar pantau laptop	neutral
membantu pemula belajar krypto bermanfaat tampilannya oke mudah dipahami	positive
pemula benerÂ² apk trading mudah tidak bikin pusing fiturÂ² nya belajar trading mending mencoba deh apk	positive
jelek penarikan dana	negative
difficult login daily connection lost	negative
penarikannya	neutral
bagus aplikasinya keren tidak susah dipakai pemula gampang dimengerti mantap	positive
lag koin tidak lengkap biaya penukaran depot tarik ngadat	negative
kenapa tunggu kerja terima pendaftarannya bukannya crypto buka jam tidak libur	positive
cocok pemula kekurangannya tidak konversi crypto terbuang kalau dikumpulkan ribu	negative
aplikasi bagus cocok pemula belajar perkriptoan trading investasi aman berizin diawasi bappebti	positive
keren aplikasinya tidak makan aset kripto ku bertambah topup mudah transaksi nya	positive
gj sinyal bagus gbisa lihat grafiknya prediksi marketnya pea	positive
withdraw	neutral
aplikasi ajaib kripto mantap penggunaan nya tidak rumit cocok pemula belajar investasii	positive
error	negative
aplikasinya gampang dipakenya pengguna trading pastinya uang	positive
aplikasinya bagus ringan mudah dipahami invest overall suka	positive
eror volume beli melonjak	negative
aplikasi investasi oke sih suka fitur nya mudah transaksinya terima kasih ajaib kripto	positive
tidak sih sinkron harganya cepat ngelek tidak seharus profit los kesal ajaib kripto beli beli harga kedebit harga taii tahi	negative
apk nya bagus investasi pemula bahasa nya memudahkan pemula belajar keamanan ganda jamin trade aman	positive
pemula tertarik berinvestasi wajib download aplikasi fiturnya mudah dipahami aplikasinya terjamin aman	positive
mencoba link kode ajaib alfipyky ku ya terima kasih	positive
komisi withdraw nya gede ya	neutral
tolong ajaib deposit baca mengikuti intruksi bangking mengirimkan uang no id ajaib tidak terdaftar memasukan id nama ajaib mengirimkan uang no id tidak terdaftar pakai dana lancar hsrus transfer dana ajaib tampilan grafik nya error tidak ketampil grafiknya prediksi tolong diperbaiki	positive
suka bug tidak	positive
apliksi haram tidak gunain bukanya uang buang uang ribu hngus tahi	negative
daftarnya gampang interfacenya simple mudah top deh	positive
cocok investasi apk nya mudah dipahami tampilannya sederhana ramah pemula	positive
suka aplikasi membantu pemula belajar kripto aplikasinya mudah dipahami nyaman diakses	positive
apa kritis menghitung pendapatan akumulasi biaya broker pajak	negative
buruk penarikan lambat menarik juta masyaallah	negative
suka aplikasinya cocok pemula mencoba investasi pembayaran mudah e wallet transfer bank pokok nya best aplikasi nya	positive
daftar deposit ribu tidak ribu	neutral
candle stick nya suka error kadang grafik lihat candle stick nya	negative
tidak tensorflow sumber dana nya tidak masuk sumber dana nya chat customer service tidak balas balas	negative
aplikasinya menarik mudah transaksi fiturnya bagus mudah dipahami disarankan	positive
pendaftaran dengar maksimal jam pas kerja pas libur sehari semenjak padaftaran pas kerja verifikasi ya	neutral
aplikasi investasi mudah pemula kayak simpan dana investasi aman verifikasi cepat mudah tidak bertele tele tampilan apps menarik mudah dipahami terpercaya semoga ditingkatkan kualitas nya	positive
gas fee bnb mahal beda	neutral
memindahkan aset exchange ajaib crypto tidak masuk aplikasi	positive
layanan pelanggan balas chatnya tidak wd	neutral
aplikasi semoga	positive
nyaman pakai aplikasi ajaib sayangnya kirim terima shib rupiah exchange rilis kirim terima aset tolong diperbaharui tidak pindah exchange	positive
ui bagus deposit instan lambat withdraw cepat fee mahal koinlisting telat exchange indonesia sayang	positive
menarik	positive
beli koin limit order pas cancel proses cenceling nya jam	neutral
pusing pakai apk	negative
aplikasinya bagus pemula belajar invest untung	positive
user dirugikan withdrawn tidak berhasil komplain email tidak diselesaikan membaca memakai ajaib kripto merugikan sistem aplikasi pengguna kantor pusatnya neo soho tidak orang kayak kantor kuburan	negative
kol disuruh reload internet lancar	neutral
minggu verif	neutral
aplikasi nya membantu jual beli aset kripto tampilan sederhana mudah dipahami pemula	positive
saldo pemotongan penarikan mahal bri potongannya	neutral
untung	positive
aplikasinya lelet	neutral
mengajak teman install daftar invest ajaib kripto ajaib saham hadiah janjikan tidak kunjung dapatkan mohon penjelasannya	positive
keamananya tak google autentikator	positive
kalau permalsahan kordinasi nya ya	neutral
eror tolong diperbaiki	negative
kasih bintang biaya penarikannya aplikasi ajaib sahamnya ribu kali penarikan kripto riburupiah penarikan kecewa ajaib kriptonya biaya penarikannya auto uninstall habis kalau eth	negative
user interfacenya mantap aplikasi crypto kekinian memudahkan cari uang anak muda rebahan	positive
aplikasi miskin sampah sokÂ² an mengadakan event peraturan ubahÂ² tidak	negative
susah close order pilih limit market order ubah susah rumit	negative
aplikasi direkomendasikan invest aplikasinya dilengkapi fitur super lengkap cocok pemula belajar crypto pay via manapun keren	positive
kacau balau parah aset tidak diapapain dijual tidak alasan maintenace	negative
saldonya an tidak apa tidak jls nih aplikasi	positive
koin nya	neutral
kali coba kripto langsung pakai aplikasi mudah dipahami loginnya gampang thanks deh	positive
aplikasi bermanfaat menghasilkan uang tampilan aplikasi mudah dipahami pemula	positive
min kenapa kirim aset kripto ajaib bursa changer tidak ya keteragan nya memiliki aset aset kripto spread nya bagus mun mohon dikurangi biaya withdraw nya biar murah min	positive
data grafik bulannya tidak cepat updateny ya	neutral
beda aplikasi apa kripto aplikasi terima kasih	positive
aplikasinya bagus mudah dimengerti pemula fitur nya keren	positive
terbaik tambahkan refral p an kali pendaftaran aplikasi ajaib kripto berinvestasi mata uang digital kripto bitcoin pemula menu tutorial nya live chat adminya ramah cepat merespon apa keluhan kita aplikasi aplikasi awasi ojk pastinya aman ya	positive
fee mahal	neutral
aplikasi bagus pemula nih tampilan mudah dimengerti aplikasi aman berinvestasi pemula registrasi tidak rumit top mencoba ayo	positive
akun tidak dibuka stuk pin	neutral
aplikasi bagus tambahkan fitur bank akun bank withdraw	positive
ajaib tolol penarikan	neutral
koin tidak kecewa	positive
ui nya simpel exchange lokal chart nya cocok trader saran mengadakan fitur stake biar orang tabung senang ajaib kripto	positive
aplikasinya mudah membantu pemula belajar keuangan fitur fiturnya keren	positive
tidak jual error keburu turun mendahului	positive
pengalaman investasi kripto rekomendasi teknikal beli rekomendasi beli untung keren sih jitu analisisnya	positive
keren deh apk nya cocok nih kali terjun bidang kripto uang deh pokoknya	positive
sayang pembelian dollar tidak limit order	negative
sayang tidak arah step step nya tidak aplikasi sebelah	negative
tadinya porto juta rupiah menerima email dengar melebihi batas transaksi juta diharuskan top saldo juta transaksi juta histori transaksi tidak kelebihan transaksi scam	negative
ajaib kripto cocok pemula kayak belajar investasi gampang bagus verifikasi data cepat tidak rumit pokoknya	positive
kecewa platform kelebihan aplikasi mudah dipahami pemula bikin jengkel maintenance layanan pelanggan slow res	negative
beli koin ondo koin nya tidak terbeli uang hilang	negative
kebanyakan aturan tidak beli tidak jual	negative
suka pakai aplikasi ajaib kripto gampang makainya tidak rumit disarankan pemula kayak coba	positive
rugi gara gara doge turun jual tidak karenakan ajaib down saran mending pakai aplikasi sebelah tidak down tidak kayak aplikasi tidak lengkap cryptonya bikin rugi orang mending mending kalau tanggung hubungin layanan pelanggan nya maaf maaf pale kamu maaf duit hilang begoo	negative
kasih fitur price alert biar harga pas jual beli bair tidak terlewat	positive
ondo prosoeknya bagemana sa beli detik menulis ulasan exchange an kenapa minus ondo berubah null semoga cepat bebenar kasihan orang minus	positive
aplikasinya bagus tampilannya mudah dipahami pemula terjun dunia crypto layanan pelanggan nya fast respon deposit penarikannya mudah pastinya aman bersertifikat bappebti	positive
koin dibanding indodax tokocrypto pintu top pakai ovo ovo manual pintu otomatis ovo verifikasi hapus akun tidak pilihan hapus akun ya	positive
nih apk harga palsu coba berkali marketcap beda hasil	negative
harga tidak sesuai market exchange	neutral
aplikasi ajaib gampang dipelajari pemula belajar kripto fitur fitur tersedia tidak terbelit belit tampilannya tidak membingungkan pemula	positive
uang tidak masuk juta cancel admin nya tidak respon	negative
apk ajaib mudah tampilan ramah user koin dalamnya koin survive aset crypto salahsatu aset potensi resiko kamu untung rugi pastikan dyor sabar tujuannya long term fluktuasi harga market	positive
aplikasi cocok investasi pemulaa nih	neutral
ditulis situ deposit jam menit tidak masuk tidak muncul saldonya saldo rdn	neutral
parah ganti akun bank persulitt	negative
pemberitahuan palsu notifikasi tulisannya eth nya turun notifikasi tidak sesuai kenyataan	negative
fitur aplikasi bagus butuh peningkatan performa	positive
hadirnya aplikasi dukungan penuh aplikasi ajaib investasi minat trading munculnya aplikasi ajaib kripto likuiditas aman amanah pengguna daftar bonus hadiah memasukkan mengapa deh refreal aplikasi bagus akurat harga saham	positive
penjualan lambat keburu turun	neutral
bagus mudah dimengerti dianjurkan pemula	positive
aplikasinya bagus pemula belajar kripto fitur fiturnya lengkap tidak rumit dipaham	positive
belajar kripto oke fiturnya gampang tidak rumit proses pencairannya apk nya terdaftar ojk aman	positive
cocok sih pemula fitur fiturnya tidak bikin pusing recommend pemula belajar investasi	positive
aplikasinya bagus mudah dipahami fiturnya lengkap cocok muat pemula kayak	positive
aplikasi bagus simpel mudah investa	positive
bingung tarailing stop tidak menemukan fitur fitur take profit stop loss kenapa tertera trailing stop ajaib perbaiki bugÂ²nya nyaman	negative
error eksekusi tidak bisaÂ² loss hadeeh	negative
aplikasi bagus pemula belajar kripto fitur fitur nya mudah tampilan nya modern stylish nyaman akses aman terpercaya pokoknya aplikasi nya the best deh	positive
notifikasi nya ilangin refres aplikasi notifikasi mohon diperhatikan bla bla menghilangkan nya	negative
aplikasi investasi aman ajaib kripto penggunaan aplikasinya mudah tutorial pemula	positive
tidak jellas update data tidak selesaiÂ² kemarin peninjauan teross	negative
keterangan harga portofolio min biar tidak hitung manual kali pembelian	neutral
aplikasi eror muncul ya kesalahan berputar tidak login	negative
aplikasi investasi bagus mudah dipahami pemula transaksinya mudah fiturÂ²nya mudah mengerti pemula direkomendasikan	positive
kenapa deposit instan nya sejam masuk deposit nya	neutral
mudah pemula pencarian scroll	positive
bagus aplikasinya keren tidak susah dipakai apa pemula gampang dimengerti mantap	positive
tampilan bagus mudah kenapa masuk tampilan chart candlestick nya stagnan tidak bergerak turun	positive
aplikasinya disarankan pemula belajar kripto fitur fiturnya mudah tampilannya modern	positive
mudah memiliki keamanan kuat diandalkan melindungi akun recommend pemula	positive
melengkapi data ketik data selesai mental gemana melengkapi kalau aplikasi mental mohon kasih solusi	positive
usaha menghasilkan uang kalau mas baim memberiku modalku insya allah sayang prgunakan sungguhÂ² bnar	positive
aplikasinya mudah tampilannya bagus cocok belajar investasi	positive
aplikasi bagus mudah dimengerti pemula gampang akses fiturnya ngebntu	positive
mengerikan error nya penjualan direject earn dengar pendapatan harian tidak buktinya status earn diproses tidak kejelasan	negative
sistem stop lost tidak pungsi berbahaya	negative
maintenance scalping boncos	neutral
update eror	negative
akun mudah dipakai aman membantu transaksi krypto	positive
aplikasinya gampang digunain cocok pemula investasi metode transfer nya beragam izin ojk aman	positive
platfrom inventasi terbaik coba mudah pemula pastinya aman	positive
mantap ajaib	positive
buruk tidak kirim kripto ganti rek bagt	negative
kebanyakan biaya admin nya harga tidak sesuai global grafik nya jelek crypto tidak dukungan nya	negative
aplikasih nya bagus mudah memahami pemula belajar investasi criypto awasi bapeti aman	positive
nice aplikasi aplikasi nya mudah pemula mudah dipahami diakses fitur fitur nya tidak rumit	positive
tolong masukkan koin pepe transaksi kirim terima	positive
kenapa riloak internet bagus	positive
top tidak wd	negative
bagus aplikasi nya cocok pemula belajar nih	positive
suka apknya langsung download apknya membantu belajar ttng kripto	positive
belajar investasi pakai aplikasi rekomen fiturnyaa mudah dipahamii	positive
pemula belajar pakai kawan-kawan fitur fitur nya mudah dimengerti gampang pakai nya rekomen	positive
apk keren pemula belajar kripto keren apk fitur fitur nya mudah mengerti tidak bikin pemula kebingungan	positive
sell aset kenapa maximal penjualan aset dimiliki tersedia kali	positive
aplikasi nya berguna worth download buruan	positive
ajaib kripto life sayer belajar invest kripto hmm tampilannya simpel mudah gunain	positive
susah deposit kripto masuk kesaldo rdn saham saldo rdn trnfer saldo kripto kena biaya rbu ajaib nyedot uang	negative
tidak pergerakan ya chartnya hilang tidak lihat tolong perbaiki kalau rugi	negative
belajar aset aset hahaha belajar otodidak	positive
apdate nya eror tolong perbaiki bug nya apdate salah salah belajar exchange pengguna nyaman	negative
bagus apk nya fitur simpel mudah mengerti pemula cocok apk nya payment nya via tidak repot deh	positive
aplikasi membantu pemula fiturnya mudah memahami nyaman diakses aman terpercaya	positive
anjir tidak gelas beli tidak antri bid rendah tidak pilihan runyem	negative
mudah belajar berinvestasi pakai ajaib	positive
update aplikasi nya order transaksi aplikasi mudah fiturnya lengkap	positive
jelek eror	negative
sumpah maintenance pas bagus transaksinya kalau pelayanan orang pindah platform sih pastinya	positive
salah aplikasi terbagus investasi jangka rekomendasi	positive
bagus aplikasinya kadang lambat transaksinya	positive
fitur earn kenapa tidak dihapus	neutral
terima kasih ajaib kripto aplikasi bermanfaat	positive
aplikasi mudah memahami dipahami pemula fiturnya bagus mantap	positive
pemula cocok nih tampilan simpel mudah dipahami	positive
aplikasi bagus pemula bermain crypto fitur ditawarkan transaksi mudah	positive
menarik ajaib luas menggarap uang potensi	positive
koin mantan tanggal pencatatannya bitcoin	neutral
belajar coba ajaib crypto pro ya	neutral
cari aplikasi kripto oke temu aplikasi kripto ajaib cocok newbie kayak mahir	positive
min saran sih tolong fitur saving staking kripto triv pintu kripto pengguna simpan bertumbuh diam mengendap tanpa apai pas market tidak stagnan	positive
dengar jam verifnya tidak verif verif	neutral
tidak rekomendasi pakai aplikasi listing koin manipulasi harga mahal harga normal intinya beli koin coba bandingkan harga nya sebelah termakan fomo	negative
lambat	neutral
cocok pemula gampang dipahami nya	positive
aplikasi nya real time candle harga tidak sinkron koin mohon perbaiki kriteria perbaiki bintang	negative
bagus pemula belajar kripto sukses ayo download fitur nya mudah dipahami	positive
bertahap	neutral
seringlah listing koin min	neutral
pantau fitur oke	positive
berpesan tolong tolong perbaikj bug selebihnya bagus	positive
bagus aplikasi nya pemula gampang mudah mengerti kripto rekomendasi aplikasi nya transaksi nya bagus	positive
aplikasi bagus pemula bagus fitur mudah dimengerti worth pemula	positive
halo bantuan Instagram ajaib kripto tidak direspon	positive
aplikasi sanagat bagus sistem nya mudah dipahami fitur fitur nya mudahh digunakann penggunaan aplikasi sangatt merasaa nyamann layanannyaa	positive
aplikasi tolol lelet	negative
keren aplikasi memudahkan pengguna pemula kayak aplikasi cryptonya tidak scam tidak lambat terpercaya pokoknya	positive
keren aplikasinya fiturnya keren tidak bikin bingung gampang gunain cinta	positive
payah nih giliran bagus ngeleg ajaib kripto bgimna nih	positive
kenapa aplikasi dijadikan akun aplikasi ajaib kripto tidak aplikasi ajaib lengkap reksadana saham mohon penjelasannya semoga akun dipakai aplikasi berbeda dijadikan aplikasi	positive
update bikin bingung angka nya koma kalau ubah tidak bikin bingung koma nya	negative
cocok investasi investasi	neutral
curang ya mengumpulkan cryptonya susah kalau nyuri nyuri orang kayak	negative
aplikasi scam	negative
parah nih aplikasi beli coin jual tidak sih mending hapus tidak	negative
aplikasi nya mudah memahami pemulaa fiturnya bagus keren tranfer rumah tidak rekomen banget	positive
aplikasi mudah mantap	positive
saran tolong tambahkan fitur ubah nomor telepon selular aplikasi aplikasi contoh indodax binance pintu pluang tokocrypto mudah mengubah nomor telepon selular tidak aplikasi ajaib ganti nomor handphone saratnya masuk pns pelanggan nyaman perubahan tidak aplikasi ajaib	positive
pembohong nih apk cari reff susah susah syarat ganti jalan	negative
ajaib kripto mudah memahami belajar kripto aplikasi nya aman berizin awasi bappebti	positive
kenapa tidak ondo kaspa koin nya lengkap	neutral
aplikasi bagus mudah dipahami memudahkan pemula belajar crypto	positive
kumpulin point selesai eror tidak klaim hadiahnya	negative
busyet akun dibuka ya dibuka pakai google gagal login nih min	negative
aplikasinya membatu pemula belajar kripto fiturnya mudah aplikasi terpercaya	positive
seru menyenangkan	positive
aplikasi bagus mudah transaksinya mudah tolong dibuatkan tombol take profit memudahkan trader capai target profit auto jual take profit terima kasih	positive
aplikasinya membantu pemula fitur fiturnya mudah mengerti	positive
deposit	neutral
rusak rusak penarikan jam malam saldo atm penarikan saldo hangus tidak terkirim	negative
kenapa withdraw tidak masuk masuk proses apk gjls cht layanan pelanggan sombong tidak	negative
woi babi bug kurangi anjing listing langsung minus ondo bug mending indodax bangsat	positive
tanggal sep tarik dana rekening tanggal sep diproses kenapa	neutral
aplikasinya bagus kendalaa fitur coin coin nya update lumayan dipahami pemula	positive
aplikasinya bagus ya mudah dipahami pemula coba belajar saham	positive
ajaib lambat tidak	negative
bagus penghasilan tambahan oke	positive
transaksinya cepat puas deech	positive
ondoonya min	neutral
penarikan lambat tolong dipercepat ketinggalan zaman lambat pajak penarikan tunggi aduh aneh apk	positive
akun pagi log out tidak login	neutral
simpel biaya penarikan mahal	neutral
rekomend suka investasi mudah pemula no bug	positive
aplikasi nya membantu mudah diakses recommend pemula pelajar belajar investasi aplikasi nya ringan tidak menuhin memori	positive
ajaib kripto simpel bikin tidak bingung terjun dunia investasi kripto cocok pemula keren fitur nya mudah keep ajaib kripto	positive
apk investasi terbaik cocok belajar trading mudah dipahami pemula disarankan	positive
tampilan aplikasinya keren mempermudah pemula belajar jual beli kripto	positive
nih apk eror	negative
grafik tidak biaya penarikan transaksi masuk portofolio	neutral
tidak metode penjual membeli cryto tanpa mengatur cl	neutral
aplikasi lelet ya mining nya wifi lancar loading nya	neutral
payah nih aplikasi menerima kripto wallet tidak mengirim tidak kumplit alamat address nya tidak ditambah biaya transaksi nya mahal bug menyesal pakai nih aplikasi	negative
server ramai ngehang _	neutral
aplikasi bermanfaat orang orang pemula aplikasi investasi keren mudah dipahami pemula pemula belajar	positive
mending disatuin tidak sih aplikasi ajaib all one one aplikasi keren option top nya perbanyak virtual acount nya hahaha berpengaruh pertimbangan pemula top asyik kalau bank nya tidak kena biaya admin	positive
pemula terjun dunia investasi	neutral
menyenangkan trading mudah bantuan analisa pemula	positive
tidak ganti email kalah aplikasi sebelah tokocrypto pintu mudah ganti email	positive
aplikasi nya maksimal down susah login	negative
keren sih aplikasi memudahkan pemula kayak nya mudah mantap pokok nya	positive
harga grafik kadang tidak sesuai harga pasar harga lain-lain binance september jam wib ajaib	neutral
aduh proses wdnya nya kalau ambil koin susah	positive
respon csnya lambat	neutral
aplikasinya oke harap akropolis masuk listing ajaib kripto potensial	positive
aplikasinya date whitelist indikatornya berubah nilai investasi tidak berubah fitur darkmode nya buka portofolio kita pilih salah coinlist tulisan harganya tidak backgroundnya putih tulisannya putih aplikasi candle stick tidak beralih tradingview tidak pergerakan bullish bearlish	negative
pas lakukan diversifikasi investasi keuntungan merata	positive
senang kemarin transaksi saham crypto reksadana aplikasi eh pisah tidak deh malas kebanyakan aplikasi	positive
pendaftaran mengecewakan	negative
menunggu dana tidak masuk rekening	neutral
apk nya bagus pemula berinvestasi mudah dipahami dimengerti gampang	positive
membeli koin kenapa tidak muncul portofolio	neutral
aplikasi tidak csnya	neutral
tolong kenapa tidak order jual coin naikÂ² nya coin berjalan bknnya coin berjalan grafik nya kenapa fitur jual tidak berfungsi limit order market order tidak berfungsi tidak take profit user	neutral
ketatnya aturan mendaftar apk bagus percaya transaksi verifikasinya menunggu jam	positive
kecewa verifikasi akun tidak	negative
jatuh cinta fitur diversifikasi portofolio aplikasi kripto ajaib mencoba kripto membantu pemula kayak potensional	positive
tampilannya bagus aplikasinya enak dipakai memudahkan belajar kripto	positive
not recommend	negative
kebanyakan pajak	neutral
suka aplikasi nya panduan kita mengerti aplikasinya mudah	positive
aplikasinya bagus mudah dipahami membantu	positive
harga tidak update	neutral
barangkali dikembangkan versi dekstop komputer	neutral
suka developer nya aset nya memadai pemula fitur nya lengkap investasi jalan	positive
aplikasinya gampang dipakai oke pemula metode transfer nya izin ojk aman	positive
aplikasinya bagus fitur fiturnya mudah pemula kripto	positive
kamu registrasi tidak email pemberitahuan pas klik tidak halaman	neutral
kenapa dimatikan limit ordernya	neutral
min penarikan e wallet biaya minimum penarikan direndahkan tolong dipertimbangkan min terima kasih	positive
kuasai	neutral
biaya admin transaksi kalau dikurangin kalau mahal malas invest	negative
gampang jual beli kripto aplikasi stabil akses lancar tampilan simpel mudah dipahami	positive
kalau komplain pelayanan cepat akurat semoga bagus	positive
untung berinvestasi aplikasi fitur nya lengkap cocok belajar trading	neutral
isinya lumayan tidak bosan lupa dilengkapi token n koin available yuk kode invite eike ochttfvr semoga uang bareng teman-teman	positive
aplikasi bagus pemula cocok investasi mudah simpel fitunya dimengerti sip	positive
enak sih gunain ajiab kripto deposit withdraw hatus menunggu kalau jam malam tolong diperbaiki dana cepat masuk	positive
sinyal full youtube aman game lancar aplikasi jaringan tidak stabil	positive
koin minimum pembelian diversifikasi cocok modal pemula	neutral
aplikasinya bagus cocok pemula fiturnya mudah tidak rumit gampang paham	positive
aplikasinya keren pemula keren sih keren pokoknya keren habis	positive
menyerankan download karana registrasi ktp tidak	positive
bug biyaya penarikan mahal	neutral
aplikasi full fitur chargenya	neutral
apk nya bagus membantu pemula belajar koripto fitur nya mudah memahami tidak bikin rumit pokoknya disarankan deh	positive
usahakan pakai broker gangguan trading kecewa berat	negative
proses penarikan lana	neutral
aplikasi nya cocok pemula fiturnya lengkap	neutral
kenapa market ramai maintenance sangar tidak memuaskan	neutral
cart nya tidak terbuka dihapus download madih tidak	negative
tampilan nya bagus cocok pemula aplikasi nya membantu	positive
bagus harganya date market bedanya kejauhan diperbaiki	positive
altcoin pepe tidak limit order payah	negative
kecewa ajaib listing ondo terselesaikan menjual tidak membeli ondo ajaib tidak bertanggung tidak apa apa mengecewakan informasi tidak apapun saran teman mencari exchange terima kasih	negative
aplikasi membantu pemula belajar aplikasi fitur mudah memahami akses aman terpercaya	positive
aplikasi butuhkan investasi kripto mudah digunakannya mudah pokoknya disarankan inves kripto diawasi aplikasinya	positive
server eror jual aset tidak	negative
aplikasi bagus pemula mudah memahami	positive
aplikasi ajaib kripto bagus pemula investasi aman nyaman	positive
rumit	neutral
angkat bagus pemula	positive
aplikasi top belajar investasi crypto menu menunya gampang	positive
cancel order buy saldo deposit tidak bertambah	negative
tidak verifikasi pakai sim	neutral
bagus mudah memahami	positive
tolong kasih opsi penambahan akun rekening penarikan buruk ah ganti rekening tidak	negative
pakai ajaib berpikir pindah tidak versi komputer	neutral
aplikasi invest satunya dipakai cocok sih pemula mantaplah	positive
ajaib crypto lelet beda ajaib saham withdraw tidak masuk rekening kontak layanan pelanggan dibaca parahg	positive
koin lengkap penarikan feenya mahal	neutral
tidak sesui	neutral
simple tidak rumit ukuran cocok orang	neutral
apk nya bagus kalau koin update token nya perbanyak min kalau koin harga kayak ondo	positive
aplikasinya cocok pemula fitur fitur memudahkan layanan aplikasinya cepat	neutral
aplikasi mudah diakses pengguna kripto pemula fitur mudah dipahami	positive
ajaib kripto life saver belajar investasi kripto sumpah interface nya simpel bantu direkomendasikan deh pokoknya	positive
tidak masuk akal beli koin proses	negative
tolong wd opsi pilihan rdn rekening saldo rdn utama	positive
kenapa gagal withdraw	negative
apk rusak verifikasi data minggu selesai tertera kerja minggu apk rusak	negative
aplikasi bagus pemula membeli kripto menu menu mudah memahami	positive
tidak sesuai event	neutral
aplikasi nya bagus wdnya e wallet bank	positive
nya coba	neutral
aplikasi bagus diperbaiki bagus nya aplikasi mudah mencari uang terbaik indonesia	positive
coin listing tidak ajaib tunggu harga muncul kalau menyesal pakai ajaib crypto download mending cari menyesal hai ajaib kripto mendengarkan keluhan user perbaiki kalau maju	negative
transaksi cepat koin nya	neutral
apk memperkaya bandar tidak kayak trading kecuali trading tipu makan duit haram	negative
heran kenapa pemliharan naiknya coin rugi	negative
benarkan sistem stop los nya nya beli tidak fungsi nya sih	negative
report ramai ramai tidak tanggung bug ondo	negative
apk nya bagus tidak tred ya kenapa karana update kah mind	positive
kenapa terbukaya diverifikasi jam	neutral
bagus tidak berpengaruh	positive
aplikasi nya mudah memahami pemula aset crypto deposit penarikan cepat	positive
beli jam pagi open keburu rugi maksudnya apa coba	negative
verivikasi akun sangaatt sangaatt lamaa bintang maaf	negative
koin koin percepat listing nya listing nya meme coin perbanyak meme koin min biar tidak ketinggalan	positive
aplikasi penipu tidak membayar teman korbannya	positive
aplikasi nya bagus pemula fitur fitur aplikasi nya membantu	positive
saldo hilang	negative
platfrom investasi keren fiturnya gampang via apapun bagus pemulaa	positive
kadang kalau kita pakai limit order transaksi status matched menunggu terlewatkan timing the market asset nya disengaja ya ditahan tahan b seharian menunggu kehilangan kesempatan trade	positive
aplikasinya bagus trading lancar pemula terbantu denfan aplikasi fitur memudahkan	positive
aplikasi nya bagus fiturnya mudah dimengerti pemula the best deh ragu ragu install	positive
bagus aplikasinya mudah dipahami fiturnya gampang	positive
lumayan sih cocok pemula investasi	neutral
aplikasi bagus invetasi pemula tidak menyulitkan kita kita belajar investasi top	positive
aplikasi ajaib kripto bantu belajar cepat memahami kripto bikin bingung paham	positive
aplikasinya mantap ngab wort pemula semoga mendalami mainnya	positive
hapus fitur penarikan saldo rdn min tidak kalau orang buru buru kerja kali	neutral
biaya penarikan	neutral
loading pin stuck	negative
aplikasi rekomendasikan fitur fitur nya bagus mudah memahami pemula tidak bikin bingung pokoknya worth	positive
tak tarik dana menungu apk nya bagus	positive
biar aplikasi super tolong tambahi fibonacci biar gambar platform terima kasih tunggu yea perkembangannya	positive
tolong kasih versi destop nya	positive
kecewa	negative
download beli coin ondo hilang tidak uangnya	negative
laporin anderson gas apk nya sampah habis	neutral
error kayak saham	negative
aplikasi tidak transaksi jual reksadana melebihi	neutral
aplikasi ngerugiin pelanggan maintenance telat ambil tindakan buy sell tolong diperbaiki	negative
menu tombol tarik menu akun penarikan tap tekan tombol pilihan bukan bank rdn bukan bank permata pilihan bank tujuan tap menu tombol tujuan menu tombol tarik tidak alias tidak muncul rupiah penarikan diisi menu tarik menu akun penarikan bank rdn menu tombol tarik tidak muncul tertutup upaya ajaib perbaiki	negative
aplikasinya keren tampilan nya simple pemula tidak bikin pusing disarankan pokoknya	positive
bug maintenence	neutral
orang pemula aplikasi mudah dipahami aman	positive
lambat transaksinya kalau deposit cepat tidak kalau withdraw lambat	neutral
sih deposid ajaib ajab kripto uang hilang heran	positive
tidak asyik tidak menarik ewalet dana	negative
aplikasi nya bagus sih fitur fitur disediakan mudah memahami nya mudah disarankan pokoknya	positive
aplikasi miskin pencuri menarik bnb jaringan bsc biya nya bnb setara ribu rupiah kacau unistall now wel done	negative
kenapa nglag tulisan nya reupload	negative
muncul notifikasi aset kripto kendala mengganggu klik tutup muncul an ng	negative
kalau daftar gambar ktp nya langsung kirim tanpa apa sesuai tidak pas tidak hm tidak mengisi nama kalau ktp nya buram	negative
fee nya kalau swap	neutral
pemula investasi makai aplikasi fiturnya bikin nyaman gampang dimengerti rekomended pokoknya	positive
aplikasinya reccomend mudah dipahami pemula coba investasi membantu	positive
error tidak dibuka tolong diperbaiki	negative
takjub apk investasi sekeren petunjuknya lengkap pemula terbantu berani investasi terjamin tidak penipuan terima kasih ajaib kripto the best investment	positive
ajaib nyaman suka aplikasi maju	positive
aplikasi nya lancar tidak iklan pokok nya the bestt	positive
mohon permurah fie jual belinya mahal fie jual belinya modal tidak maksimalin profitnya fie nya mahal	positive
event kebanyakan gimmick dengar lambat desember distribusi nya eh tanggal tidak masuk hahaha	negative
aplikasi bagus mudah pemula trading tampilan fiturnya mudah dimengerti	positive
transaksinya cepat aplikasinya aman	positive
simpel cocok pemula masuk dunia investasi	neutral
ya aplikasi bagus fitur menarik tanpa batas	positive
bagus aplikasinya semoga	positive
witdraw jam malam tidak	negative
tampilan aplikasinya menarik sederhana dipahami pemula main kripto	positive
suka apikasi membantu pemula belajar kripto semoga ditingkatkan	positive
mending uang tabung bank drpa biaya admin invest	positive
mengirim pesan adminny engak balas alesanny tunggu antrian apknya tidak serame tidak balas bos	neutral
pengguna buka aplikasi dicegat banner pop fullscreen agresive ngiklannya	negative
aplikasi bagus cocok pemula kayak belajar kripto tampilannya gampang dipahami fitur fiturnya simple tidak bikin bingung rekomended nih	positive
kenapa tradingviewnya tidak ya dihp	neutral
tlong diperbaiki kita untung rugi tidak dibuka apknya tidak beritahu kon maintenance	neutral
aplikasi penipu anjing suruh veli crypto saldo ribu pas beli tidak hilang menu klaim hadiahnya	neutral
keke senang pakai ajaib kripto proses tarik dana nya cepat suka	positive
aplikasi simple coba fitur mudah dipahami pemula tampilan bagus mudah dimengerti bagus belajar investasi	positive
agent customer service nya tidak memberikan informasi lambat mebalas pesan disayangkan	negative
mantap	positive
aplikasi tidak kenapa saldo earn tak masuk	neutral
reward lupa memasukan kode ajaibnya kuntygk	positive
penanganan tidak sesuai layanan pelanggan nya bot t menunggu jam tangani	neutral
aplikasi nya bagus pemula belajar dunia trading membantu fitur layanan nya mudah dipahami depot withdraw cepat pokoknya rekomended pemula wajib coba investasi sih trusted kawan-kawan terpercaya cinta	positive
aplikasinya bagus ratenya memudahkan pemula belajar memahami nya	positive
bagus grafiknya telat viewnya tidak digeser geser pergerakan misalnya jam jam semoga disesuaikan exchange	positive
aplikasi nya bagus banget	positive
fitur fitur mudah memahami pemula belajar kripto aplikasinya gampang mudah dimengerti pokoknya rekomend	positive
aplikasinya bagus pemula fitur fiturnya cocok belajar	positive
deposit nya ampun keterangan deposit instan jam masuk masuk hadehh tidak deh transaksi kapok	positive
aplikasinya cocok pemula fitur fiturnya lengkap gampang dipahami prosesnya cepat pencairan e wallet transfer bank disarankan sih	positive
suka sih suka coin mesti telat listing	positive
aplikasi nya ngeleg	neutral
bintang pelayanan layanan pelanggan nya slow respon tidak informatif pakai template	neutral
biaya transaksi jual beli mahal pajak kalau rugi kena biaya transaksi pajak aduh	negative
min ajaib harga ondo nyentuh dollar binnance ribu	neutral
apk niat tidak sih apa tutup token coin nya telat memasukan coin kripto apk nya	neutral
halo pasang top profit mengapa berubah ya mengapa saldo berkurang profit berkurang	positive
ajaib kripto apk gampang dipahami pemula belajar trading kripto	positive
aplikasi sampah	neutral
ajaib kripto bagus aplikasinya fiturnya lengkap mudah dipahami cocok pemula berinvestasi kripto	positive
buka akun berhari tidak kejelasan uninstal	negative
kenapa tidak lihat chard pergerakan harga	neutral
aneh deposit biayanya kali deposit dipotong biaya deposit Ã pk kirim deposit keterimanya utuh tidak pemotongan	negative
aplikasi bagus pemula nih fitur nya mudah memahami tidak rumit	positive
aplikasi membantu investor crypto pemula cocok tampilan simple masukkan refferal ahmagy aset crypto gratis teman-teman	positive
crypto tidak lengkap download aplikasi	neutral
transaksi jual beli tertahan	neutral
cocok jual beli crypto fitur nya simpel mudah memahami cocok pemula keren ajaib kripto	positive
kekurangan tidak lengkap cryptonya	negative
aplikasinya bagus kalau notifikasi kali kenaikan penurunan persentasi harga crypto pengguna lupa masukkan kode bonus ajaib nya ya arisxtxg tanpa tanda kutip pengguna bonus hadiah kalau pakai kode terima kasih	positive
kenapa bembukaan akun terbuka tolong balas kalau tidak kasih bintang kalau balas bintang mantap	positive
lumayan komplit trading viewnya nya coba e tidak nya enak mantap	positive
direkomendasikan lupa pakai kode reff dodijthw	neutral
semoga nyaman pengguna mengayomi ajaib berinvestasi	positive
kak kenapa portofolio rekap transaksi oasis network hilang	negative
aplijasi sampah systemnya error menghitung event referral undang orang pakai device kali sumpah tolol nih systemnya bukanya bagus ambruk	negative
turun kesabaran ketelitian	negative
woy tarik nya pakai dana rumit kali pakai ngab nian tidak lengkap aset nya rumit penarikanya pakai dana woy pindah aplikasi sebelah we	positive
aplikasi metode penarikan instan cih	neutral
aplikasi nya bagus rekomendasikan pokoknya mendukung kita penghasilan	positive
min perbaiki space minernya kalau lambat masuknya	neutral
aplikasinya bagus cocok pemula mudah dipahami fitur fitur nya bagus deh membantu	positive
aplikasinya bagus rekomended investor pemula cocok deh newbie fitur membantu pemahaman trading aman biaya transaksinya relatif murah	positive
aplikasi cocok investasi pemula tampilan aplikasi informatif	neutral
aplikasi membantu pemula belajar kripto tidak takut aplikasi nya aman terpercaya cocok rekomendasi pemula belajar main cripto	positive
kali mencoba	neutral
cut profit dibedakan jadikan misal beli bitcoin harganya murah beli harga termurah harganya jual dijadikan harga biar jual masukan terima kasih	positive
aplikasi ajaib kripto menyenangkan fiturÂ² nya mudah digunakam cocok pemula pengguna kripto	positive
aplikasinya simple mudah dipahami pribadi maaf tidak no npwp aplikasinya lapor	positive
cocok pemula fitur fiturnya mudah memahami penarikannya mudah	positive
barusan download aplikasi kripto ajaib impressed fitur mukanya friendly habis kalau semangat belajar kripto deh	positive
aplikasi nya bagus mudah dioperasikan tidak rumit fitur nya lengkap	positive
aplikasinya mudah pemula gampang paham kerja aplikasi invest modal ayo	positive
apk nya bagus adakan nya koin xno nano please min kalau kasih bintang deh	positive
fitur aplikasi lengkap cocok era serba sat set rekomendasi guysz	positive
aplikasi fitur fiturnya mudah gampang dimengerti pemula belajar invest kripto	positive
aplikasi nya mudah fitur fitur nya transaksi penarikan cepat selesai	positive
aplikasi mudah pemula nih bagus fitur fiturnya mudah mengerti	positive
kadang suka bug mining	positive
aplikasi tak daftar mnggu jawabn	neutral
tidak login	neutral
aplikasinya tidak rumit interfacenya kece please nih ajaib kripto fitur notifikasi harga kripto biar kalau menarik satset langsung update	positive
verifikasi	neutral
nyaman enak tampilannya gampang dipakai pemula kyc mudah deposit withdraw mudah cepat aman	positive
aplikasi membantu kita mempermudah	positive
kecewa profit tidak dijual sl delay dijual alhasil rugi prah	negative
keren pemula mudah memahami tolong penarikan biar ewallet dana biar simpel penarikan prosses beli paket data pulsa	positive
gunanya apa sih	neutral
aplikasinya bagus disarankan pemula berinvestasi kripto fiturnya tidak rumit mudah dipahami	positive
mencoba investasi kemudahan aplikasi fitur simple mudah berinvestasi jangka pendek jangka	positive
terima kasih costumer care ajaib crypto memberikan tanggapan akun terima kasih	positive
ku kasar genting mya jual aset tidak maintenance apa ya pas market dum lali pakai apk anjing mending hapus	negative
tampilannya sederhana berinvestasi pemula	neutral
temu aplikasi kripto keren sih pemula memudahkan berinvestasi aman amanah promo menarik fitur fiturnya mudah mengerti pemula rekomendasi nih aplikasi terpercaya	positive
kenyamanan apk nya memuaskan cocok pemula	positive
mari belajar aplikasi transaksinya cepat depot nya cepat tidak bikin rumit	neutral
pembelian harga turun minus pembelian selesai cancel tidak klik cancel digantung ujung terbeli langsung minus server jelek	negative
tidak rekomend dana stuck koin tidak uangnya hilang laama nongol	negative
aplikasi nya bagus fitur fitur nya memudahkan pengguna nyy cocok nih pemula investasi crypto pokokny top aplikasi semoga bagus	positive
biaya withdraw nya mahal min kenapa tidak disamakan aplikasi saham bi fast	neutral
aplikasinya bagus gampang mengerti pemula berguna penghasilan cair nya cepat	positive
chart aset tidak muncul beranda ngebug aset pergerakan harganya terhenti situ	positive
erorr urus aplikasi tidak sih parah	negative
aplikasinya keren mudah dimengerti terpercaya aplikasi bagus pemula berinvestasi disarankan	positive
aplikasi mudah pemula top rekening e walet apa praktis prosesnya cepat gabung masukan kode ajaib nandhbyc hadiah aset crypto gratis admint crypto request koin ondo min	positive
kenapa susah buka aplikasinya ya lancarÂ² buka aplikasi muterÂ²	negative
aplikasi ajaib investasi cocok pemula belajar investasi	neutral
aplikasi nya mudah mengerti pemula fitur nya menarik	positive
withdraw masuk	neutral
kalau dibandingkan aplikasi crypto aplikasi terburuk transaksi loadingnya nilai pajak dibanding aplikasi tidak dipantau komputer tidak direkomendasi memakai aplikasi	negative
tolong aplikasi nya benarkan min tidak deposit	neutral
aplikasi cacat bug	negative
sih tidak tarik duit order	neutral
jam tidak dibuka internet tidak stabil buka aplikasi aman	positive
bagus bsnget aplikasi cocok pemula keamanan terjamin tenang invest	positive
apk nya ramah pemula mudah dipahami kyc nya gampang mantap thanks ajaib kripto	positive
pelayanannya bagus fast respon	positive
porto hijau market bagus eeh aplikasinya error tidak jual hahaha ajaib	negative
pakai ajaib sadar harga beli jual terlampau kena fee kalau modal	neutral
ajaib kripto uang maksimal asli cinta menjanjikan deh asyik main kripto	positive
aplikasi terbaik pemula belajar investasi keamannya terjamin hasilnya terjamin	positive
simpel nyaman elegan nice one	positive
aplikasi lelet verifikasi tidak fast respond	neutral
setor wallet biaya minimal sih cari uang kustomer	neutral
apk nya cari simpel terjun dunia investasi kriptoan	neutral
ajaib mengapa candle stick tidak update buka candle doge kemarin tidak berubah merugikan user candle muncul time fram daily	neutral
aplikasi bermanfaat kita aplikasi anti lelet lancar tidak gangguan	positive
mengapa tidak jual kenapa ya	negative
hey aplikasi hello aplikasi salam ya maaf tidak karyawan aplikasi pakai derama masyarakat kalau derama main main bersi titip pesan aplikasi ya salam	positive
aplikasi kripto gampang pemula terpercaya	positive
ajaib mantap transaksi cepat nyarin nya secepat kilat	positive
ajaib crypto tolong kebijaksanaannya merefund reset bug aset ondo error system orang entry ondo harga tidak masuk akal	positive
apknya foto vertivikasi ktp tidak investasinya	neutral
rekomendasi nih mudah pakenya	positive
desain mudah memahami cocok pemula sngat recomend deh ajaib kripto ringan keren sih ajaib kripto	positive
apk tahi error bahaya srkali kalau topup	negative
bagis	positive
aplikasi muai coba pakai wow aplikasi bagus fiturnya keren cepat bertransaksi loh kuberi bintang	positive
apk membatu pemula belajar kripto tampilannyaapun sederhana mudah mengerti	positive
membeli coin harganya beda coba kasih minimal contoh contoh nanovest minimal koin	positive
pembelian aset apapun minimum nya tidak rekomen ajaib tidak berinvestasi modal rupiah	positive
depot saldo tidak masuk masuk	neutral
susah kyc membubuhkan tanda tangan	negative
aplikasi ringan price aset real time vitur vitur nya oke kekurangannya tidak vitur price alert	positive
aplikasinya cocok pemula fiturnya mudah dipahami direkomendasikan pemula	positive
ajaib sih tidak lihat portofolio daftar no handphone beda sih konsepnya	positive
aplikasi membantu investasi pemula entah jangka pendek fiturnya mudah dimengerti tidak rumit aplikasi disarankan pemula	positive
lancar kencang aplikasi nya	neutral
aplikasinya pisah aplikasi ajaib aplikasi investasi tolong tambahkan keamanan autentikasi faktor ajaib kripto aman	positive
gila transfer wd kena biaya mahal tidak kayak ajaib saham gratis pindah sekeluarga pluang gratis	positive
payah	negative
tidak worth registrasi error tidak kayak apk pintu mudah	negative
kak tolong ku nge bug uang nya tak all ondo tidak kebaca witlis	positive
kalau saran aplikasi nya jadikan mempermudah berinvestasi terima kasih	positive
jeroan sistem apk bagus sayang kekurangan proses deposit dana penarikan eror sinyal bagus tolong perbaiki	positive
enak sih mudah memahami	positive
keren aplikasinya cocok pemulaa	positive
chart analisis nya suka ngebug	positive
mantap mudah penguanaan aplikasinya penarikan cepat jam kerja	positive
aplikasi investasi bagus pemula belajar investasi mudah fitur aplikasinya tidak membingungkan bagus	positive
cocok pemula suka tampilannya biaya tarik	positive
minggu registrasi proses prosesnya mnunggu uninstal	neutral
ya aplikasi investasi mudah pemula cuanna sih keren aplikasi	positive
parah mah harga pasar imx ribu giliran dijual harga ribuan sumpah parah tidak rekomend install mending apk sebelah	negative
server sistem busuk pasang limit jual sehari nya harga limit jual nya aset tidak kejual cancel order tidak	neutral
pakai aplikasi inindah eror nya respon layanan pelanggan lambat	negative
tolong tingkat apy fitur earn ding	positive
error	negative
aplikasi bagus jenis investasinya transaski aman berizin withdraw nya cepat gampang	positive
tidak sebulan tidak jual	neutral
tolonglah koin listing bug portofolio sisa tidak tindakan kompensasi	positive
real grafik portofolio beda error entah kondisikan	negative
kenapa menarik hasil coin nambang tidak wd tidak dklik minning nambang deposit	negative
aplikasinya membantu daftarnya mudah fitur bagus cocok pemula segi interfacenyaa	positive
bagus serius aplikasi membantu kita belajar kripto fitur sederhana memudahkan kita aplikasi pokoknya disarankan pemula	positive
aplikasi membantu pemula fitur berguna penggunaan mudah memahami	positive
fiturnya gampang memahami oke update coinynya gerak cepat mantap ajaib cripto semoga	positive
chat support agent tidak respon layani pakai robot ai iya deposit tidak transaksi beli cripto panik menarik tidak alasan nya bekukan kalau iya bekukan kenapa deposit tidak transaksi menarik tidak apai deposit	negative
saran orang transaksi jual ya cair deposit rekening alihkan transaksi pemula nya hilang bukan pindah aset kita aset meningkat bukan transaksi pindahkan kecewa	negative
aplikasinya bagus	positive
bagus aplikasinya cepat mengerti aplikasi investasi tebaik sin pemula fitur ajarkan dalamnya dyor teman teman investasi riset tanpa ajakan fomo orang pemula memasukan putrkpgj bonus promo aplikasinya	positive
fee mahal semnjak rek rdn rumit auto uninstal mudah	positive
rekomen belajar investasi fiturnya bagus midah dipahami	positive
biaya penarikan deposit mahal	neutral
aplikasinya bagus	positive
penarikan	neutral
order juta gara gara lambat hilang	negative
kasih bintang jual harga tidak	negative
aplikasi membantu pemula fiturnya mudah dipahami keamanannya terjamin suka main kripto cocok deh aplikasi	positive
mudah pemula fiturnya lengkap	positive
tidak beli ondo	neutral
aplikasi ajaib kripto aman pastinya terpercaya fiturnya mudah	positive
gangguan woi tidak login	neutral
koinnya	neutral
kiripto apk nya error susah jual giliran turun normal sih lawak	negative
investasi nya aman diawasi bapebti tidak khawatir rekomendasi pemula	positive
sayang penarikan via ewallet susah	negative
pemula belajar jual beli kripto aplikasi recomend pokoknya fiturnya tidak rumit gampang dimengerti	negative
verifikasi akun ya	positive
bagus mengajukan tampilkan pnl harian bulanan pikir untung portofolio bagus	positive
aplikasi suka gangguan biaya admin nya mahal	neutral
susah menganti nomor telepon	negative
aplikasinya mudah ramah pengguna semoga tidak kendala	positive
rekommended sih aplikasi fiturnya lengkap mudah dipahami membantu pokoknya	positive
transaksi cepat lancar	neutral
ferivikasi email aplikasi menunggu	neutral
aplikasi sampah upload ktp eror tulisan invalid flow	negative
menurutku aplikasi cocok pemula bahasanya mudah dipahami tampilannya tidak kalah menarik janlup fitur fiturnya oke deh nyaman kalau akses aplikasi	positive
please verifikasi akun min sehari	positive
aplikasi buruk	negative
biaya depot pas menarik rugi rugi	negative
eror bug diperbaiki tranksaksinya payah nih server down gara gara jual beli ganti progamer	negative
aplikasi bagus mudah rekomended pemula tapilan fitur fitur menarik mudah jalankan telepon selular	positive
deposit banking bukan nomor rekening nya nya nomor virtual akun virtual akunnya tidak anneh	neutral
aplikasinya bagus pemula fiturnya tidak bikin pusing orang belajar	positive
najis apk bukannya kasih pemberitahuan kalau kedeteck akunnya kasih promo kirim email kecewa parah apk mending tidak kayak rumet mengadakan event entot semoga depelopernnya kasih pertimbangan rugi juta aduh	positive
lihat grafik nya analisa teknikal rumit	neutral
susah daftar nya coba berkali kali nomor handphone ku terdaftar nya daftar akun aplikasi payah	negative
aplikasi nya bagus mudah memahami pemula belajar investasi kripto	positive
bagus apknya trading crypto aman cocok pemula gampang kemudahan invest	positive
aplikasinya mudah fitur nya lengkap cocok pemula belajar kripto	positive
space manner tambang hitam huhuhu scam	negative
aplikasi nya enak friendly user mudah pemula ayo buruan inves kripto halving bitcoin jual	positive
bagus apk investasi nominal nya kalau belia apa hasil investasi	neutral
saldo habis bayar potongan biaya deposit transaksi deposit kena biaya apk kena pas beli kripto kena gila sih	negative
eror ya merubah order layanan layanan pelanggan tidak fast	neutral
kekurangannya wajib bintang menyesal pakai aplikasi tidak edit watchlist indicator tidak realtime ketiga perubahan rekening bugnya	negative
aplikasinya bagus mudah dipahami pemula kayak rekomended investasi	positive
apk nya bagus lengkap btc eth atom system perdagangan nya mudah memahami pencairan cepat nggx rumit	positive
beli crypto kena pajak jual crypto kena pajak tidak	neutral
aplikasi bagus pemula design enak fitur mudah dipahami pencairannya pokoknya mantap deh pemula	positive
kadang apk error tolong dibenarkan	neutral
transaksi stengah proses buset admin	neutral
wd salah penarikan larinya bank permata chat costom nya tidak balasÂ²	positive
penarikan dana tidak masuk sampahh	negative
ajaib kripto ajaib simple pemula fitur nya oke semoga fitur oke ya mantap menyala ajaib kripto	positive
maintenance jam kerja pintar biar ambil uang ya tidak sell mending download sebelah	positive
platform investasi terbaik pemula aman tidak rumit registrasi data terjaga aman penarikan mudah	positive
menyesal main	negative
aplikasi nya mudah memahami pemula belajar kripto fitur nya bagus disarankan	positive
rekomended pemula belajar investasi fiturnya mudah gampang dimengerti	positive
multibit bug harga tidak sinkron	neutral
ayo min benarkan listing coin ondo tidak beli sih	neutral
aplikasinya bagus user interface user friendly mudah dipahami pemula pokoknya the best ajaib kripto	positive
mudah bertransaksi crypto tak pakai rumit semoga bermanfaat	positive
sulit masuk akun install ajaib disuruh registrasi ulang no handphone tidak mohon bantuannya invest space coins tidak hilang terima kasih	negative
tarik dana kilogram berubah pindah dana tidak	negative
eror woy ngeri kali naruh uang an lambat eror parah sih ajaib tidak ajib	negative
min uang hilang tba tba verivikasi verivikasi setahun dana hlangg solusinya	negative
aplikasi helpfull navigasi mudah update tidak lag thankss	positive
download transaksi beli cepat aplikasi lancar mantap deh pokoknya	positive
tampilannya tidak dibaca sederhana	neutral
aplikasinya mudah pemula ui nya bagus	positive
aplikasinya mudah	positive
mencoba mudahan uang	positive
salut apk membantu berinvestasi telepon selular tanpa rumit makan sat set pokoknya keren	positive
data grafik tidak wifi data seluler coba wifi	neutral
daftarnya minggu tidak terima terima kirim berkali kali apk gaguna	negative
uang kondisi untung membeli aset tidak rugi uang hilang juta ajaib mencuri uang pelanggan bukti transaksi aplikasinya langsung ambil uang dasar perampok ditelusuri transaksinya harap ajaib cepat bangkrut mengambil uang orang	negative
bagus aplikasinya membantu belajar kripto aplikasi nya aman terpercaya	positive
pokoknya rekomendasi install apk trading mudah aman terjangkau gratis biaya transaksi	positive
fitur fitur nya lengkap tidak rumit mudah dipahamin tidak bug belajar pakai aplikasi gampang dipakai	negative
aplikasi trading kripto cocok pemula biaya transaksi murah prosesnya aman cepat beli koin kripto mudah	positive
pajak nya mahal apk nya lelet tidak worth	negative
menyenangkan invest ajaib	positive
ui mudah dipahami	positive
aplikasi crypto anjurkan install fitur nya canggih mudah dipakai keamanan super ketat pertahankan	positive
penarikan	neutral
aplikasi mudah pemula fitur lengkap cocok investasi	positive
tampilan oke proses deposit cepat koin lengkap sayyangnya ondo tidak dibeli kadang eror koneksi restart semoga update	negative
proses verifikasi selesai jam seharian tunggu tidak selesai selesai	neutral
aplikasi bagus investasi ringan cocok pemula menu nya lengkap mudah nya aman	positive
profesional event nya alasan	neutral
penasaran kalau coba apk nya sesuai rating nya busuk apk nya sampah loh aplikasi investasi seburuk lambat tidak real time harga nya tidak cocok trading	negative
kali pakai ajaib menyenangkan fiturnya lengkap mudah pemula	positive
cocok pemula fiturnya lengkap mudah dipahami	positive
nya coin klay wemix kalau coin wemix klay nya bintang nya	neutral
error	negative
aplikasi cocok rekomended pemula belajar kripto aplikasinya mudah fitur fitur lengkap pastinya terpercaya	positive
rndr tidak match aduh	neutral
bagus sih izinkan wd akun dana deposit dana masak menarik saldo dana tidak	positive
bagus cocok pemula suka jual beli crypto fiturrnya keren mudah dipahamii	positive
kalau bagus bintang	positive
ajaib keren cocok pemula tidak rumit super simple	negative
aplikasinya bagus mantap sih aplikasi investasi mudah simpel pemula wajib sih download aplikasi rekomendasi pemula	positive
admin nya mahal tidak dasar lintah darat	neutral
coba pencet tombol fitur earn kawan aset kamu tahan kalau tarik prosesnya kesal tidak pemberitahuan aset ditahannya pokoknya dipencet earn nya takutnya bearish tidak buruÂ²dijual	positive
ketikan pump dump signifikan aplikasi tidak buka hahaha	negative
simple tidak rumit pstnya menguntungkan	negative
rugikan ajaib kripto beli ondo limit order ribu terbeli harga ribu ganti kerugian siapa harga ondo kerugian	negative
pakai aplikasi tanggung merugikan user	neutral
mohon bantuannya developernya masuk jaringan lelet jual aset kriptonya tidak gagal	positive
interface mudah dipahami tidak rumit detail mudah diakses good	positive
aplikasinya berguna jual beli crypo proses transaksinya mudah lamcar mantaplah	positive
notifikasi mohon diperhatikannya muncul ditutup kali menghilangkannya	positive
pergerakan harganya lambat biaya transfer crypto tidak ngotak	positive
teman teman down aplikasi sehari uang hilang juta tidak kenapa	positive
berharap ajaib listing orbs network koin semoga respon terima kasih	positive
jeleknya aplikasi tidak riwayat pembelian kripto riwayat pembelian sih tidak kasih lihat detail beli kripto harga coinnya	negative
min verifnya kali	positive
aplikasinya cocok pemula fiturÂ²nya menarik penjelasan nya mudah memahami terima kasih ajaib semoga memuaskan	positive
woi menarik kenapa portofolio tidak muncul muncul	positive
eror	negative
aplikasi mudah fitur fiturnya mudah dipahami membantu kegiatan sehari harinya oh ya tidak memakan ruang tunggu ayo pakai aplikasi bermanfaat	positive
aplikasi membantu pemula belajar kripto fitur fiturnya sederhana pemula mudah aplikasi pencairan e wallet transfer bank pokoknya disarankan pemula	positive
lupa install ajaib kripto aplikasi bagus coba orderbook nya real time oh iya kalau daftar lupa pakai kode unik dafadyj hadiah crypto gratis	positive
kemarin mengikat akun bank diajaib cribto akun bank tidak diterima terikat nomor handphone nomor handphone sms duit masuk kalau tidak orang pakai akun mending binance aman mudah registrasi diajaib registrasi berbelit sosmet koar cari pelanggan giliran registrasi dipersulit maaf mending uninstal aplikasi ajaib mengecewakan member	positive
apk nya bagus cocok pemula fiturnya mudah dipahami belajar investasi otodidak	positive
tolong kebnykn eror nya	negative
aplikasi nya cepat tidak lambat pemula berjnvestasi mudah aplikasi kita disediakan beragam fitur lengkap mudah dimengerti	positive
coba kalau bagus ku bintang nya	positive
tampilan aplikasi nya bagus cocok pemula mencoba berinvestasi fitur lengkap ber regestrasi nya mudah aplikasi zaman mudah the best	positive
aplikasi bermanfaat pemula berinvestasi	positive
aplikasi nya bagus fitu disajikan mudah semoga	positive
aplikasi membantu kita belajar crypto cocok pemula tampilan nya bagus mudah dimengerti	positive
dana kripto hilang	negative
kenapa tanda tangan erorr koneksi bermasalah	negative
aplikasi ajaib kripto bagus penarikan dananya baca kenapa tidak ditarik wallet dana ya	positive
kenapa limit order koin dihilangkan uang grup tele hilangkan kebijakan apa	neutral
eror delay ajaib ajaib coin lengkap fitur design ui jelek semoga ditingkatkan exchange kalau tidak niat mending tidak bikin aplikasi	neutral
please apk nya bermanfaat newbie belajar kripto	positive
ferivikasi susah	negative
aplikasinya bagus membantu pemula ditambah fitur fiturnya mudah	positive
aplikasi manipulasi loss nya jual profit tidak menunggu loss jual pastikan loss profit apliksi curang	negative
aplikasi user friendly fiturnya tidak bikin bingung cocok pemula belajar aset kripto asli aman tidak khawatir deh	positive
tolong buatkan notifikasi undang teman aplikasi ajaib kita teman kita ajak bergabung	positive
aplikasi mudah lancar login mudah cepat penarikan dana simpel	positive
pemula memakai aplikasi mudah dipahami cocok investasi pemula aplikasi nya terdaftar ojk aman deh aplikasi investasi jangka jangka pendek	positive
kenapa eror ajaib harga pasar order book berbeda tolong devoloper perbaiki mengganggu tidak memantau harga market asli	negative
aplikasi sampah btc halving langsung ngelag momen menjual menit ajaib aplikasinya ngelag menit apa ya pemakainy dirugikan hati pakai aplikasi	negative
gen ajaib kripto memudahkan tampilannya kece fiturnya gampang dimengerti	positive
aplikasi nya harga selisinya jawuh aplikasi sebelah sebelah harga btc	neutral
menyesal progran earn aplikasi prosesnya	negative
aplikasi busuk deposit susah tensorflow pakai virtual account bank market order jebakan tidak beli kripto ribu	negative
menarik layanannya bagus install apknya far aman semoga aman ya	positive
parah tidak singkron pembelian coba buk tiin ya kalau tidak bukannya untung buang uang	negative
belajar	neutral
nih tidak akun tulisan nya kesalahan	negative
apk nya bagus layanan nya mudah alat nya efisen memudahkan pengguna	positive
tolong ajaib support investor trender pemula kalau fitur stoplose nya harga beli crypto dibeli melambung investor trender uang guyuran biaya widraw mahal pemodal ratusan ribu terbebani menggerus keuntungan kerugian kita saran biaya wd	positive
tidak solusi aset coin diberhentikan disuruh cari suruh kirim wallet wallet coin diberhentikan tidak solusi nih parah	negative
tampilan aplikasinya tidak membingungkan langsung paham apa kegunaannya	positive
belajar investasi kripto asyik lho pakai pakai ajaib kripto gampang dipahami grafik harga paham	positive
biaya penarikan mahal potongan mahal harga pas kalah aplikasi menang harga	positive
penarikan proses kemarin masuk parah sumpah	negative
cocok pemula profesional	neutral
aplikasi tolol	negative
aplikasinya gampang dipakai pemula kayak terjamin aman diawasi kementrian perdagangan	positive
kyc	neutral
pemotongan fee penarikan	neutral
suka trading pakai apk ajaib kripto mudah aman terpercaya pemula kayak ditunggu updateÂ²nya biar bagus ya	positive
proses stake nya percepat nya	neutral
pas grafik harga rendah pas belii harganya tibaÂ² tidak sesuai grafik	negative
kasih bintang kalau berpengasilan daru kripto kasih bintang	neutral
keamanan aplikasi memiliki sistem keamanan enkripsi tingkat sistem keamanan ganda transaksi kriptocurrency aman user friendly antarmuka pengguna aplikasi mudah mudah dipahami pemula aplikasi menyediakan fitur informasi membantu pengguna memahami pasar kriptocurrency	positive
halo ajaib mengeluhkan pergantian no rekening terkendala mengapa pergantian no rekening baca tidak dirubah blu baca	negative
aplikasi membantu sih mudah pemula	positive
kasih bintang ya aset kripto daftar kirim terima wallet usul aset kripto aplikasi dilengkapi fitur terima kirim	positive
jelek biaya admin penarikan mahal	negative
pakai kode lanaxdxt tambahan	neutral
portopolio tidak jual kenapa ya	neutral
aplikasi kripto ajaib ajaib sih tidak mengerti kripto semenjak pakai aplikasi paham deh	neutral
koin vanry kirim aplikasi pintu e walet polygon matic tidak aplikasi ajaib min hubungin admin chat balesan	neutral
ajaib harga lain-lain aplikasi google an ajaib an kita tidak harganya tidak real benarÂ² ajaib kejadian rabu wib tanggal september bikin kapok pakai aplikasi januari maintenance jam pagi siang molor jam malam withdraw benerÂ² mengerikan market down sport jantung	positive
bagus mohon update kedepanya tolong ajaib crypto diinstal komputer laptop terima kasih	positive
mudah dipahami	positive
sumpah aplikasi gampang pelajari pemula fitur fitur nya mudah memahami keren	positive
tidak npwp daftar bikin akun tidak ya	neutral
aplikasinya tidak rumit mantap coba invetasi	neutral
butuh perbaikan tambang gratisnya bos harga spot halvingnya bos	positive
aplikasinya lelet tolong perbaiki terkadang eror tidak buka	negative
aplikasi nya memuaskn	positive
mantap mudah suka ajaib	positive
pemula investasi nih pakai apk mempermudah tidak rumit tampilan nya	positive
menambang space miner tidak tidak berhasil mengajak teman loading loading loading loading loading loading loading loading loading loading loading loading loading loading loading loading loading loading loading loading loading loading loading loading loading loading loading loading loading loading loading loading loading loading loading loading loading loading loading loading loading loading buang kuota lapor email layanan pelanggan tidak ditanggapi	negative
ajaib kripto exchange aneh tetapkan harga jual sekian orderbook beda harganya otomatis target tidak kesampe sumpah exchange aneh	negative
proses setoran earn aktif nya	positive
kode ariepfym	neutral
fitur stop loss take profit buy scroll pilihan pasang stop loss dhrga take profit dharga berpa konfirmasi pembelian	negative
koin koinnya update ondo tidak beli pengawasan saran cepat update coin listing cex nya koin listing cex ajaib biar pilihan terima kasih	positive
eror muluk aplikasinya	negative
mudah dipahami	positive
pemula membantu a suka dunia trading fitur nya simple mudah memahami	positive
suka pelayanan nya sarankan menyediakan peserta ajaib crypto orang membingbing pengguna cepat memberitahu informasi ajaib crypto sekian terima kasih	positive
koin masuknya ketinggalan kalau price nya	neutral
donwload	neutral
lumayan bagus diperbaiki bugnya chart lihat candel stilk berubah line tidak perbaiki	positive
aplikasi nya sederhana	neutral
aplikasi scam harga berbeda market	negative
buruk penjualan kripto tidak tekan tombol jual	negative
platform investasi bagus pemula belajar investasi fitur fitur mudah memahami the best deh apk ajaib kripto	positive
hasil nya	neutral
pakai ajaib kripto tidak mengalami kendala apapun proses transaksi aman cepat membatasi minimal kerugian tanpa memantau apk	positive
sistem grafiknya mudah memahami proses jual belinya mudah fiturnya simple tidak bikin rumit	positive
download transaksi nya cepat aplikasi lancar bagus lengkap pokoknya aplikasinya mantap	positive
aplikasi suka eror eror	neutral
kebanyakan potongan fee	negative
aplikasi mudah dipahami pemula investasi fitur fiturnya modern sederhana transaksi tidak kendala cinta apk	positive
aplikasinya membantu pemula mudah fitur menarik disarankan deh	positive
pemula membantu inter face sederhana mudah dimengerti	positive
eror	negative
tidak pusing belajar crypto aplikasi direkomendasikan pemula fiturnya keren mudah dipahami keren deh pokoknya	positive
ajaib kripto salah aplikasi investasi mudah dipakai pemula fasilitas tawarkan beragam kemudahan	positive
aplikasi kripto terbaik ajaib tampilannya mudah memahami belajar kripto transaksi jual beli kripto mudah withdraw nya cepat aplikasi rekomendasi	positive
biaya adminya lumayan gede kalau dananya ya menunggu laju kali ya tarik dana	neutral
kocak erorr tidak jual beli	neutral
tidak depot ya coba via mbca nomor tujuan tidak terdaftar	negative
tolong cart nya biar aset crypto jadikan inves terima kasih kasih bintang kalau sesuai	positive
penarikan uang nya proses kalau deposit cepat menyesal infes aplikasi	negative
suka ajaib kripto fitur notifikasi harga ya biar kalau harga menarik	positive
tarik dana berhasil	positive
kalau mending digabungin apk nya handphone ram tidak muat memori kalau download apk	positive
aplikasi bagus simple senang pakai pemula aset kripto mohon perbanyak mohon tinggtknlagi	positive
apk bagus mudah praktis mohon koinÂ² kripto sats penarikan e wallet nya bersaing aplikasi terima kasih	positive
rumit penarikanya butuh	neutral
aplikasinya cocok aman pemula investasi fiturnya mudah memahami penjelasannya simpel	positive
tolong cepat perbaiki bug apk notifikasi keterlambatan layanan susah tutup scrol ya susah notifikasi	negative
loginnya mudah memudahkan belajar kripto cocok pemula fiturnya mudah dimengerti	positive
min koin ondo tidak rilis min keburu harganya rilis	neutral
tolong token dmasukan	positive
aplikasi membantu pengalaman	positive
hati hati apk depsit diamkan minggu saldo hilang	negative
suka aplikasi transaksi jual beli aset kripto bitcoin btc tidak biaya aplikasinya alias gratis	positive
aplikasinya bagus mudah dimengerti untu pemula belajar kripto transaksinya fitur bagus mudah tidak rumit untum fituf kriptonya mudah	positive
memiliki saldo rupiah ajaib kripto belikan salah aset kripto coba beli tidak laku uang hilang tidak aset kripto	negative
menyenangkan muda dipahami pemula sukses	positive
malas	negative
chat layanan pelanggan tidak	neutral
kalau update koin	neutral
aplikasi pemula investasi	neutral
puas ajaib menganti data nomer telepon sulit rumit	positive
tidak buka komputer laptop	neutral
top rdn eror tidak masuk respon layanan pelanggan nya lambat	negative
tampilannya fitur apps mohon dicantumkan mode trading view nya	positive
penarikan uang nya rumit kocak beda indodax langsung dana e wallet apk busuk jiing	negative
belajar ajaib	neutral
aplikasi keren membantu fitur fiturnya bermanfaat best	positive
saldo investasi sulit dijual transaksi nyeleneh	negative
aplikasi mudah pemula belajar kripto fitur fitur simple mudah diakses nyaman aman terpercaya	positive
permainan harga beli coin crypto harga nilai crypto nya tidak muncul tidak dijual harga turun nilai crypto muncul kita rugi tidak rekomen	neutral
pasang stop loss kecuali pas beli tolong fitur jual stoploss	negative
mencoba	neutral
download semoga berjalan lancar	positive
tidak apload identitas	neutral
menu penarikan ditarik ewallet	neutral
aplikasi kripto scam tidak pakai teman-teman pakai pluang indodax aplikasi menghisap uang bukan harga turun loh ya apa apa admin admin adminnya gila menarik rdn aplikasi gratis aplikasi anjing	negative
biaya whidraw mahal btc rekening pribadi potongan kena rban mahal mohon perbaiki	negative
banyakan pemberi harapan palsu biar tergiur dengar referal doge senilai iming iming juta biar tergiur	positive
cocok nih aplikasinya pemula investasi fitur fiturnya membantu	positive
mantap apk ajaib kripto semoga berjaya memberikan informasi pengalaman berimpestasi semangat ajaib kripto	positive
penipuan iming iming uang penipu biar download kontol abisin kuota bangsad	negative
bagus saran tolong aset kripto stable coin eurs paxg investor konservatif menaruh uangnya aset kripto tidak volatil dijaminkan aset riil paxg nilainya peg emas	positive
aplikasi ajaib kripto cocok pemula berinvestasi pakai aplikasi nyaman penarikan mudah fitur e wallet	positive
bagus simple mudah cripto listing	positive
aplikasi mudah cocok pemula rekomended sih	positive
rumayan sih pemula	positive
aplikasinya disarankan fiturnya mudah dipahami cocok nih pemula hahaha	positive
kenapa pagi buka ajaib tidak apa gara jualan tidak	negative
aplikasi nya bagus pemula belajar dunia trading aman berinvestasi fiturnya mudah dipahami	positive
csnya kita tidak menit langsung diselesain csnya tidak kasih solusi	negative
tidak buka portofolio siang aneh nya	negative
aplikasinya mudah dipahami rekomendasi pemula fitur fiturnya sederhana suka pokoknya disarankan deh	positive
fiturnya lengkap tidak pintu pluang	neutral
aplikasi friendly membantu belajar kripto memuaskan	positive
aplikasinya mudah pemula fiturnya lengkap tidak bingung	positive
trader tipu kita beli tidak sesuai harga smestinya layananny mengecewakan	negative
tak transaksi jual beli kripto jual beli diplatform mengapa ajaib tidak tertulis error	neutral
pilihan coin crypto lengkap tambahkan koin tersedia aplikasi ajaib	neutral
coin menerima kayak menerima koin pilihan	positive
platform investasi terbaik penggunaan apk nya aman bermanfaat dijamin aman data terjamin deh aplikasi nya bagus	positive
apps nya bagus investasi fitur fiturnya menarik gampang dipahami keren semoga bermanfaat investasi	positive
aplikasinya aneh harga nya tidak sesuai tertara manipulasi harga nya kalau kita lihat cat nya pas turun bebarengan koin jam nya	negative
error tidak transaksi tr tolong kasih solusinya	negative
aplikasi tidak live chat tidak jam hati hati aplikasi chat penipu mentransfer uang	negative
fee penarikan withdrawl mahal	neutral
semoga ajaib kripto jaya ditingkatkan fitur fiturnya aman amanah jujur profesional	positive
tidak ajaib saham tidak ajaib crypto bikin rugi keputusan bei	negative
update koin kalo	neutral
lengkapi fiturnya	neutral
bintang gbisa beli ondo	neutral
buatkan versi webnya	neutral
aplikasinya aman trading bitcoin crypto overall menarik gampang sih pemula	positive
ajaib kripto bikin investasi kripto nyaman mudah dipahami fitur ya gampang coba coba tanpa takut salah	positive
kendala tidak lihat portofolio	negative
cancelling harga turun	neutral
potongan adminnya	negative
tidak menarik dana	neutral
wdnya sush	positive
tooll indikator susah analisis teknikal berani main ajaib kabari kalau tool indikator	neutral
ajaib kripto salah aplikasi crypto aman transaksi lancar cocok pemula aplikasinya mudah	positive
adminnya tidak ngotak tolong kecilin kirim wallet adminya	negative
tolong fitur short and long aplikasi sebalah potongan tarik saldo nya gratisin ajaib saham	positive
parah chat tidak dibalas email tidak dibalas niat buka aplikasi tidak dana tidak masuk dasar aplikasi no respon	negative
bintang permanen jual ftm harga harga order match bid order penipuan	negative
tolong koin ondo diperbaiki transaksi	positive
harga crypto tidak sinkron lambat tidak mihat saldo perbaiki	neutral
aplikasi nya bagus pemula investasi crypto fiturÂ² mudah memahami membantu mudah thebest pokoknya	positive
aplikasi error order jual prosesnya	negative
scam anjing	negative
aplikasi bagus membantu pemula mudah belajar kripto	positive
tidak stop loss limit order sell harga set limit order nya tidak set stop loss	negative
handphone charts tidak dirubah candlestick tombol mengubah charts tidak mohon diperbaiki	negative
menyesal main ajaib tidak realtime jatohnya maling duit nasabah	negative
biaya admin pas wd nya tolong terbebani orang orang trading	positive
memantau membandingkan aplikasi coinbase pintu luno hati investasi berizin hati kasih bintang kalau bagus bintangnya	positive
aplikasinya bagus mudah fiturnya menarik gampang dimengerti newbie kayak	positive
aneh kali beli perbaikan sistem harga turun tidak masuk akal tak sesuai harga krypto aslinya	negative
tanks ajaib kripto withdraw	neutral
aplikasi nya mudah pengguna fitur nya mudah memahami	positive
cancel dibelikan ajaib diharga maruk batas deck	negative
ajaib kripto ngebug ya	neutral
tolong kalau deposit instant mahal ajaib kasih bintang kalau biayanya seribu	positive
keren nih aplikasinya transaksinya cepat	positive
koin kaspa ajaib kripto min	neutral
ondo kenapa suspen aduh apa ajaib	negative
aplikasi kripto suka perfect tidak lambat suka tidak pindah	positive
ah tidak pas halving btc pemeliharaan	negative
registrasi nya	neutral
tolong kenapa tidak jual saham beli tolong perbaiki	positive
bagus tolong tambahinn fitur kirim koin kirim usdt btc koin kirim dompet	positive
kenapa deposit pakai va bni nomer va salah nih	negative
aplikasinya enak gampang dipahami transaksi nya murah	positive
kalau open posisi close posisi lambat jaringan bagus lambat nya kalau withdraw	neutral
bagus lengkap kirim terima pengguna baca menguntungkan bagus	positive
proses verifikasi setujui nya	neutral
nilai persenan turun nominal harga cek apk kondisi harga pasar semoga	positive
gila apk tarik potongan anjing en tidak gur gimick asu	negative
we kadang kalau malam lalot	neutral
kenapa uang tarik tidak atm	neutral
registrasi hadiah	positive
teansaksinya mantap	positive
mudah tampilan nya tidak aplikasi kripto percaya	positive
semenjak updatean tidak mengerti susah mending hapus tadinya menambah inves setelh mempelajari kembalikan akun tidak mengerti	negative
aplikasi nya eror nya distribusi event nya tidak sesuai malas deh pakai apk nya mah	negative
verifikasi jumat selesai selesai	neutral
aplikasi penipu sampah tak berguna hapus aplikasi play store tidak mendaftar	negative
selebihnya lumayan broker maju update coin crypto tolong langsung update tidak ketinggalan cuannya tolong sl nya mudah eksekusi nya mudah ty semoga maju update	positive
aplikasi exchange aneh harga beli pepe rupiah coin dijual rupiah bukan pergi the moon pergi uninstall biar tidak dikadalin hahaha	negative
jual tidak	negative
error tidak wd	negative
djancok update ngerepotin limit ordernya hilang market order mesti mantengin layar	negative
aplikasi membantu pemula belajar invetasi membantu mudah dimengerti semoga	positive
pemula dunia kripto bingung pakai ajaib kripto fiturnya lengkap mudah dipahami penarikan lancar	positive
coba ya kalau bagus kasih bintang	positive
dengar free biaya pearikan penarikan dikenakan biaya tolong perbaiki aplikasinya update	positive
kasih bintang tidak tarik saldo e wallet	neutral
langsung matched melewati harga limit jual tidak matched	neutral
modalin iklan iklan tidak sesuai kenyataan nya	neutral
penipuan	negative
coba staking	neutral
teruntuk pengguna bilang newbe krypto wajib coba nih apk mudah dipahami keren terpercaya mudah memahami	positive
kalau cepat listing coin	neutral
apknya berguna gampang pemula fitur fiturnya lengkap terima kasih ajaib kripto	positive
hati hati tidak rekening pribadi giliran deposit mah uang ngendap akun tidak diambil gagal rekening pakai rekening bank apapun ktp terdaftar ajaib crypto gagal	negative
masuk jeakun susah gji	negative
jembut barang kejual duit menunggu	neutral
layanan pelanggan nya kayak bot dia balas pakai template makan gaji buta kalau sih pecat layanan pelanggan tidak suruh ngrim foto ss rekaman layar kasih aneh layanan pelanggan nya apa tidak kasih solusi layanan pelanggan nya bocah kayak nya kasihan ajaib crypto karyawan kaum rebahan malas mengapa apa	negative
kenapa mines porto harganya tidak turunÂ² buy mines tipu sih harga porto tidak turunÂ² market turun drastis	negative
gangguan koneksi dengar apa internet aplikasi buruk	negative
verif nyala unistal tidak	neutral
aplikasi nya bagus sayangnya fitur cl order	positive
jujur kali mencoba investasi apk membantu berinvestasi	positive
aplikasinya membantu pemula bingung rekomend pemula	positive
order book nya sulit indodax	negative
aplikasi jelek tidak mentang mentang orang main kripto biaya adminnya gede kocak tidak pokoknya rumit kamu main pakai mending binance	negative
apk nya bagus investasi fiturÂ²nya mudah dipahami tidak rumit bagus pemula kayak mantap pokoknya	positive
biaya penarikannya rugilah kalau penarikan dikenakan biaya	negative
apk nya membantu pemula belajar kripto fitur aplikasinya mudah tidak bikin pusing	positive
kasih bintang market nya lengkap koin tokenfi tidak ondo tidak buy narative buy rwa kasih bintang bertambah market koin nya	negative
aplikasinya mudah dimengerti pemula kendala fitur suka pokoknya disarankan pemula	positive
membantu meningkatkan nilai uang aplikasi mudah registrasi	positive
aplikasi penipu hati banyakbpenipuan aplikasi bonus tidak daftar berhaail	negative
kurangnya tambahkan penarikan exchange penarikan e wallet fee mahal deposit exchange penarikan exchange tidak tersedia tolong ditingkatkan	negative
aplikasi bagus investasi mudah dipahami aman cepat diproses fitur apk nya lengkap	positive
aplikasinya keren cocok pemula belajar mudah dipakenya	positive
bagus harga koin tidak real time bug	positive
ya pemula langsung semangat kripto diajaib meningkatkan investasi berkelanjutan ya gas	positive
kenapa habis upadate tidak dibuka apknya	neutral
pilihan crypto nya	neutral
ajaib kripto kayaknya kalau tambahan fitur notifikasi harga oke deh biar pengguna langsung update kalau menarik	positive
aplikasi sampah sumpah aplikasi scam menarik gagal muncul invalid input kita tidak jual diangka kita tentukan mengikuti harga terendah pasarnya	negative
susah kali verifikasi ktp berulang coba gagal pakai ktp teman gagal alasan jaringan eror jaringan ku bagus	negative
download menunggu fitur chartnya aplikasi sahamnya chart diajaib kripto terbatas tidak enak teknikalis	negative
aplikasi ajaib kripto bagus fitur fiturnya lengkap mudah aman terpercaya	positive
apk investasi keren simpel mudah dipahami fiturnya joss	positive
customer service lelet tidak jalan gbsa wd tidak kejelasan customer servicenya pakai aplikasi	negative
mantap mudah dipahami semoga ditambah koin token vestin nya	positive
